model,decoding_method,beam_size,problem_id,input_tokens,output_tokens,total_tokens,score,source_file,row_index
Llama,origin,15,15_1000#1,81,289,370,0,LLAMA3/origin/MATH500/15_1000.jsonl,1
Llama,origin,15,15_1000#2,144,1000,1144,0,LLAMA3/origin/MATH500/15_1000.jsonl,2
Llama,origin,15,15_1000#3,80,553,633,1,LLAMA3/origin/MATH500/15_1000.jsonl,3
Llama,origin,15,15_1000#4,45,143,188,0,LLAMA3/origin/MATH500/15_1000.jsonl,4
Llama,origin,15,15_1000#5,360,331,691,0,LLAMA3/origin/MATH500/15_1000.jsonl,5
Llama,origin,15,15_1000#6,73,127,200,0,LLAMA3/origin/MATH500/15_1000.jsonl,6
Llama,origin,15,15_1000#7,52,462,514,1,LLAMA3/origin/MATH500/15_1000.jsonl,7
Llama,origin,15,15_1000#8,99,1000,1099,0,LLAMA3/origin/MATH500/15_1000.jsonl,8
Llama,origin,15,15_1000#9,67,243,310,1,LLAMA3/origin/MATH500/15_1000.jsonl,9
Llama,origin,15,15_1000#10,174,652,826,0,LLAMA3/origin/MATH500/15_1000.jsonl,10
Llama,origin,15,15_1000#11,57,368,425,0,LLAMA3/origin/MATH500/15_1000.jsonl,11
Llama,origin,15,15_1000#12,92,1000,1092,0,LLAMA3/origin/MATH500/15_1000.jsonl,12
Llama,origin,15,15_1000#13,101,211,312,1,LLAMA3/origin/MATH500/15_1000.jsonl,13
Llama,origin,15,15_1000#14,204,173,377,1,LLAMA3/origin/MATH500/15_1000.jsonl,14
Llama,origin,15,15_1000#15,144,305,449,0,LLAMA3/origin/MATH500/15_1000.jsonl,15
Llama,origin,15,15_1000#16,211,1000,1211,0,LLAMA3/origin/MATH500/15_1000.jsonl,16
Llama,origin,15,15_1000#17,54,354,408,1,LLAMA3/origin/MATH500/15_1000.jsonl,17
Llama,origin,15,15_1000#18,240,639,879,0,LLAMA3/origin/MATH500/15_1000.jsonl,18
Llama,origin,15,15_1000#19,179,324,503,1,LLAMA3/origin/MATH500/15_1000.jsonl,19
Llama,origin,15,15_1000#20,81,481,562,1,LLAMA3/origin/MATH500/15_1000.jsonl,20
Llama,origin,15,15_1000#21,46,127,173,0,LLAMA3/origin/MATH500/15_1000.jsonl,21
Llama,origin,15,15_1000#22,62,1000,1062,0,LLAMA3/origin/MATH500/15_1000.jsonl,22
Llama,origin,15,15_1000#23,158,579,737,1,LLAMA3/origin/MATH500/15_1000.jsonl,23
Llama,origin,15,15_1000#24,61,604,665,0,LLAMA3/origin/MATH500/15_1000.jsonl,24
Llama,origin,15,15_1000#25,130,448,578,1,LLAMA3/origin/MATH500/15_1000.jsonl,25
Llama,origin,15,15_1000#26,112,1000,1112,0,LLAMA3/origin/MATH500/15_1000.jsonl,26
Llama,origin,15,15_1000#27,85,379,464,0,LLAMA3/origin/MATH500/15_1000.jsonl,27
Llama,origin,15,15_1000#28,110,219,329,0,LLAMA3/origin/MATH500/15_1000.jsonl,28
Llama,origin,15,15_1000#29,67,205,272,1,LLAMA3/origin/MATH500/15_1000.jsonl,29
Llama,origin,15,15_1000#30,110,252,362,0,LLAMA3/origin/MATH500/15_1000.jsonl,30
Llama,origin,15,15_1000#31,57,385,442,0,LLAMA3/origin/MATH500/15_1000.jsonl,31
Llama,origin,15,15_1000#32,41,157,198,0,LLAMA3/origin/MATH500/15_1000.jsonl,32
Llama,origin,15,15_1000#33,84,211,295,1,LLAMA3/origin/MATH500/15_1000.jsonl,33
Llama,origin,15,15_1000#34,78,482,560,1,LLAMA3/origin/MATH500/15_1000.jsonl,34
Llama,origin,15,15_1000#35,66,605,671,1,LLAMA3/origin/MATH500/15_1000.jsonl,35
Llama,origin,15,15_1000#36,74,162,236,1,LLAMA3/origin/MATH500/15_1000.jsonl,36
Llama,origin,15,15_1000#37,62,1000,1062,0,LLAMA3/origin/MATH500/15_1000.jsonl,37
Llama,origin,15,15_1000#38,67,249,316,0,LLAMA3/origin/MATH500/15_1000.jsonl,38
Llama,origin,15,15_1000#39,74,219,293,0,LLAMA3/origin/MATH500/15_1000.jsonl,39
Llama,origin,15,15_1000#40,55,232,287,1,LLAMA3/origin/MATH500/15_1000.jsonl,40
Llama,origin,15,15_1000#41,130,130,260,1,LLAMA3/origin/MATH500/15_1000.jsonl,41
Llama,origin,15,15_1000#42,83,318,401,0,LLAMA3/origin/MATH500/15_1000.jsonl,42
Llama,origin,15,15_1000#43,73,314,387,0,LLAMA3/origin/MATH500/15_1000.jsonl,43
Llama,origin,15,15_1000#44,107,551,658,0,LLAMA3/origin/MATH500/15_1000.jsonl,44
Llama,origin,15,15_1000#45,97,408,505,1,LLAMA3/origin/MATH500/15_1000.jsonl,45
Llama,origin,15,15_1000#46,69,177,246,0,LLAMA3/origin/MATH500/15_1000.jsonl,46
Llama,origin,15,15_1000#47,77,486,563,1,LLAMA3/origin/MATH500/15_1000.jsonl,47
Llama,origin,15,15_1000#48,84,350,434,1,LLAMA3/origin/MATH500/15_1000.jsonl,48
Llama,origin,15,15_1000#49,52,199,251,1,LLAMA3/origin/MATH500/15_1000.jsonl,49
Llama,origin,15,15_1000#50,58,217,275,1,LLAMA3/origin/MATH500/15_1000.jsonl,50
Llama,origin,15,15_1000#51,129,255,384,0,LLAMA3/origin/MATH500/15_1000.jsonl,51
Llama,origin,15,15_1000#52,55,829,884,1,LLAMA3/origin/MATH500/15_1000.jsonl,52
Llama,origin,15,15_1000#53,63,127,190,1,LLAMA3/origin/MATH500/15_1000.jsonl,53
Llama,origin,15,15_1000#54,60,75,135,1,LLAMA3/origin/MATH500/15_1000.jsonl,54
Llama,origin,15,15_1000#55,45,65,110,0,LLAMA3/origin/MATH500/15_1000.jsonl,55
Llama,origin,15,15_1000#56,83,228,311,0,LLAMA3/origin/MATH500/15_1000.jsonl,56
Llama,origin,15,15_1000#57,57,125,182,1,LLAMA3/origin/MATH500/15_1000.jsonl,57
Llama,origin,15,15_1000#58,87,548,635,0,LLAMA3/origin/MATH500/15_1000.jsonl,58
Llama,origin,15,15_1000#59,47,146,193,0,LLAMA3/origin/MATH500/15_1000.jsonl,59
Llama,origin,15,15_1000#60,79,335,414,0,LLAMA3/origin/MATH500/15_1000.jsonl,60
Llama,origin,15,15_1000#61,83,1000,1083,0,LLAMA3/origin/MATH500/15_1000.jsonl,61
Llama,origin,15,15_1000#62,102,375,477,1,LLAMA3/origin/MATH500/15_1000.jsonl,62
Llama,origin,15,15_1000#63,139,913,1052,0,LLAMA3/origin/MATH500/15_1000.jsonl,63
Llama,origin,15,15_1000#64,122,800,922,0,LLAMA3/origin/MATH500/15_1000.jsonl,64
Llama,origin,15,15_1000#65,99,886,985,0,LLAMA3/origin/MATH500/15_1000.jsonl,65
Llama,origin,15,15_1000#66,47,198,245,1,LLAMA3/origin/MATH500/15_1000.jsonl,66
Llama,origin,15,15_1000#67,71,160,231,1,LLAMA3/origin/MATH500/15_1000.jsonl,67
Llama,origin,15,15_1000#68,81,227,308,0,LLAMA3/origin/MATH500/15_1000.jsonl,68
Llama,origin,15,15_1000#69,94,1000,1094,0,LLAMA3/origin/MATH500/15_1000.jsonl,69
Llama,origin,15,15_1000#70,89,1000,1089,0,LLAMA3/origin/MATH500/15_1000.jsonl,70
Llama,origin,15,15_1000#71,53,146,199,1,LLAMA3/origin/MATH500/15_1000.jsonl,71
Llama,origin,15,15_1000#72,53,229,282,0,LLAMA3/origin/MATH500/15_1000.jsonl,72
Llama,origin,15,15_1000#73,67,228,295,1,LLAMA3/origin/MATH500/15_1000.jsonl,73
Llama,origin,15,15_1000#74,104,325,429,1,LLAMA3/origin/MATH500/15_1000.jsonl,74
Llama,origin,15,15_1000#75,60,204,264,0,LLAMA3/origin/MATH500/15_1000.jsonl,75
Llama,origin,15,15_1000#76,71,324,395,1,LLAMA3/origin/MATH500/15_1000.jsonl,76
Llama,origin,15,15_1000#77,73,171,244,1,LLAMA3/origin/MATH500/15_1000.jsonl,77
Llama,origin,15,15_1000#78,52,128,180,1,LLAMA3/origin/MATH500/15_1000.jsonl,78
Llama,origin,15,15_1000#79,102,1000,1102,0,LLAMA3/origin/MATH500/15_1000.jsonl,79
Llama,origin,15,15_1000#80,54,115,169,1,LLAMA3/origin/MATH500/15_1000.jsonl,80
Llama,origin,15,15_1000#81,75,1000,1075,0,LLAMA3/origin/MATH500/15_1000.jsonl,81
Llama,origin,15,15_1000#82,82,186,268,0,LLAMA3/origin/MATH500/15_1000.jsonl,82
Llama,origin,15,15_1000#83,120,420,540,0,LLAMA3/origin/MATH500/15_1000.jsonl,83
Llama,origin,15,15_1000#84,55,1000,1055,0,LLAMA3/origin/MATH500/15_1000.jsonl,84
Llama,origin,15,15_1000#85,86,390,476,1,LLAMA3/origin/MATH500/15_1000.jsonl,85
Llama,origin,15,15_1000#86,93,341,434,1,LLAMA3/origin/MATH500/15_1000.jsonl,86
Llama,origin,15,15_1000#87,71,105,176,0,LLAMA3/origin/MATH500/15_1000.jsonl,87
Llama,origin,15,15_1000#88,57,297,354,1,LLAMA3/origin/MATH500/15_1000.jsonl,88
Llama,origin,15,15_1000#89,120,1000,1120,0,LLAMA3/origin/MATH500/15_1000.jsonl,89
Llama,origin,15,15_1000#90,53,377,430,0,LLAMA3/origin/MATH500/15_1000.jsonl,90
Llama,origin,15,15_1000#91,74,134,208,0,LLAMA3/origin/MATH500/15_1000.jsonl,91
Llama,origin,15,15_1000#92,76,299,375,0,LLAMA3/origin/MATH500/15_1000.jsonl,92
Llama,origin,15,15_1000#93,73,464,537,0,LLAMA3/origin/MATH500/15_1000.jsonl,93
Llama,origin,15,15_1000#94,75,455,530,1,LLAMA3/origin/MATH500/15_1000.jsonl,94
Llama,origin,15,15_1000#95,375,1000,1375,0,LLAMA3/origin/MATH500/15_1000.jsonl,95
Llama,origin,15,15_1000#96,113,734,847,1,LLAMA3/origin/MATH500/15_1000.jsonl,96
Llama,origin,15,15_1000#97,137,1000,1137,0,LLAMA3/origin/MATH500/15_1000.jsonl,97
Llama,origin,15,15_1000#98,76,198,274,0,LLAMA3/origin/MATH500/15_1000.jsonl,98
Llama,origin,15,15_1000#99,51,156,207,0,LLAMA3/origin/MATH500/15_1000.jsonl,99
Llama,origin,15,15_1000#100,130,1000,1130,0,LLAMA3/origin/MATH500/15_1000.jsonl,100
Llama,origin,1,1_1000#1,81,147,228,0,LLAMA3/origin/MATH500/1_1000.jsonl,1
Llama,origin,1,1_1000#2,144,1000,1144,0,LLAMA3/origin/MATH500/1_1000.jsonl,2
Llama,origin,1,1_1000#3,80,493,573,1,LLAMA3/origin/MATH500/1_1000.jsonl,3
Llama,origin,1,1_1000#4,45,141,186,0,LLAMA3/origin/MATH500/1_1000.jsonl,4
Llama,origin,1,1_1000#5,360,224,584,0,LLAMA3/origin/MATH500/1_1000.jsonl,5
Llama,origin,1,1_1000#6,73,109,182,0,LLAMA3/origin/MATH500/1_1000.jsonl,6
Llama,origin,1,1_1000#7,52,541,593,0,LLAMA3/origin/MATH500/1_1000.jsonl,7
Llama,origin,1,1_1000#8,99,828,927,0,LLAMA3/origin/MATH500/1_1000.jsonl,8
Llama,origin,1,1_1000#9,67,205,272,0,LLAMA3/origin/MATH500/1_1000.jsonl,9
Llama,origin,1,1_1000#10,174,417,591,0,LLAMA3/origin/MATH500/1_1000.jsonl,10
Llama,origin,1,1_1000#11,57,1000,1057,0,LLAMA3/origin/MATH500/1_1000.jsonl,11
Llama,origin,1,1_1000#12,92,1000,1092,0,LLAMA3/origin/MATH500/1_1000.jsonl,12
Llama,origin,1,1_1000#13,101,254,355,0,LLAMA3/origin/MATH500/1_1000.jsonl,13
Llama,origin,1,1_1000#14,204,158,362,1,LLAMA3/origin/MATH500/1_1000.jsonl,14
Llama,origin,1,1_1000#15,144,333,477,0,LLAMA3/origin/MATH500/1_1000.jsonl,15
Llama,origin,1,1_1000#16,211,563,774,0,LLAMA3/origin/MATH500/1_1000.jsonl,16
Llama,origin,1,1_1000#17,54,79,133,1,LLAMA3/origin/MATH500/1_1000.jsonl,17
Llama,origin,1,1_1000#18,240,1000,1240,0,LLAMA3/origin/MATH500/1_1000.jsonl,18
Llama,origin,1,1_1000#19,179,1000,1179,0,LLAMA3/origin/MATH500/1_1000.jsonl,19
Llama,origin,1,1_1000#20,81,1000,1081,0,LLAMA3/origin/MATH500/1_1000.jsonl,20
Llama,origin,1,1_1000#21,46,127,173,0,LLAMA3/origin/MATH500/1_1000.jsonl,21
Llama,origin,1,1_1000#22,62,1000,1062,0,LLAMA3/origin/MATH500/1_1000.jsonl,22
Llama,origin,1,1_1000#23,158,1000,1158,0,LLAMA3/origin/MATH500/1_1000.jsonl,23
Llama,origin,1,1_1000#24,61,450,511,0,LLAMA3/origin/MATH500/1_1000.jsonl,24
Llama,origin,1,1_1000#25,130,187,317,0,LLAMA3/origin/MATH500/1_1000.jsonl,25
Llama,origin,1,1_1000#26,112,649,761,0,LLAMA3/origin/MATH500/1_1000.jsonl,26
Llama,origin,1,1_1000#27,85,273,358,0,LLAMA3/origin/MATH500/1_1000.jsonl,27
Llama,origin,1,1_1000#28,110,207,317,1,LLAMA3/origin/MATH500/1_1000.jsonl,28
Llama,origin,1,1_1000#29,67,107,174,0,LLAMA3/origin/MATH500/1_1000.jsonl,29
Llama,origin,1,1_1000#30,110,539,649,0,LLAMA3/origin/MATH500/1_1000.jsonl,30
Llama,origin,1,1_1000#31,57,1000,1057,0,LLAMA3/origin/MATH500/1_1000.jsonl,31
Llama,origin,1,1_1000#32,41,160,201,0,LLAMA3/origin/MATH500/1_1000.jsonl,32
Llama,origin,1,1_1000#33,84,227,311,0,LLAMA3/origin/MATH500/1_1000.jsonl,33
Llama,origin,1,1_1000#34,78,1000,1078,0,LLAMA3/origin/MATH500/1_1000.jsonl,34
Llama,origin,1,1_1000#35,66,612,678,1,LLAMA3/origin/MATH500/1_1000.jsonl,35
Llama,origin,1,1_1000#36,74,323,397,1,LLAMA3/origin/MATH500/1_1000.jsonl,36
Llama,origin,1,1_1000#37,62,660,722,0,LLAMA3/origin/MATH500/1_1000.jsonl,37
Llama,origin,1,1_1000#38,67,1000,1067,0,LLAMA3/origin/MATH500/1_1000.jsonl,38
Llama,origin,1,1_1000#39,74,125,199,0,LLAMA3/origin/MATH500/1_1000.jsonl,39
Llama,origin,1,1_1000#40,55,252,307,0,LLAMA3/origin/MATH500/1_1000.jsonl,40
Llama,origin,1,1_1000#41,130,392,522,0,LLAMA3/origin/MATH500/1_1000.jsonl,41
Llama,origin,1,1_1000#42,83,262,345,0,LLAMA3/origin/MATH500/1_1000.jsonl,42
Llama,origin,1,1_1000#43,73,85,158,1,LLAMA3/origin/MATH500/1_1000.jsonl,43
Llama,origin,1,1_1000#44,107,612,719,0,LLAMA3/origin/MATH500/1_1000.jsonl,44
Llama,origin,1,1_1000#45,97,205,302,0,LLAMA3/origin/MATH500/1_1000.jsonl,45
Llama,origin,1,1_1000#46,69,62,131,1,LLAMA3/origin/MATH500/1_1000.jsonl,46
Llama,origin,1,1_1000#47,77,363,440,0,LLAMA3/origin/MATH500/1_1000.jsonl,47
Llama,origin,1,1_1000#48,84,161,245,1,LLAMA3/origin/MATH500/1_1000.jsonl,48
Llama,origin,1,1_1000#49,52,240,292,1,LLAMA3/origin/MATH500/1_1000.jsonl,49
Llama,origin,1,1_1000#50,58,219,277,1,LLAMA3/origin/MATH500/1_1000.jsonl,50
Llama,origin,1,1_1000#51,129,1000,1129,0,LLAMA3/origin/MATH500/1_1000.jsonl,51
Llama,origin,1,1_1000#52,55,902,957,1,LLAMA3/origin/MATH500/1_1000.jsonl,52
Llama,origin,1,1_1000#53,63,112,175,1,LLAMA3/origin/MATH500/1_1000.jsonl,53
Llama,origin,1,1_1000#54,60,75,135,1,LLAMA3/origin/MATH500/1_1000.jsonl,54
Llama,origin,1,1_1000#55,45,75,120,1,LLAMA3/origin/MATH500/1_1000.jsonl,55
Llama,origin,1,1_1000#56,83,123,206,0,LLAMA3/origin/MATH500/1_1000.jsonl,56
Llama,origin,1,1_1000#57,57,125,182,1,LLAMA3/origin/MATH500/1_1000.jsonl,57
Llama,origin,1,1_1000#58,87,560,647,0,LLAMA3/origin/MATH500/1_1000.jsonl,58
Llama,origin,1,1_1000#59,47,162,209,0,LLAMA3/origin/MATH500/1_1000.jsonl,59
Llama,origin,1,1_1000#60,79,216,295,0,LLAMA3/origin/MATH500/1_1000.jsonl,60
Llama,origin,1,1_1000#61,83,591,674,0,LLAMA3/origin/MATH500/1_1000.jsonl,61
Llama,origin,1,1_1000#62,102,562,664,1,LLAMA3/origin/MATH500/1_1000.jsonl,62
Llama,origin,1,1_1000#63,139,553,692,0,LLAMA3/origin/MATH500/1_1000.jsonl,63
Llama,origin,1,1_1000#64,122,449,571,0,LLAMA3/origin/MATH500/1_1000.jsonl,64
Llama,origin,1,1_1000#65,99,895,994,0,LLAMA3/origin/MATH500/1_1000.jsonl,65
Llama,origin,1,1_1000#66,47,136,183,1,LLAMA3/origin/MATH500/1_1000.jsonl,66
Llama,origin,1,1_1000#67,71,242,313,1,LLAMA3/origin/MATH500/1_1000.jsonl,67
Llama,origin,1,1_1000#68,81,180,261,0,LLAMA3/origin/MATH500/1_1000.jsonl,68
Llama,origin,1,1_1000#69,94,1000,1094,0,LLAMA3/origin/MATH500/1_1000.jsonl,69
Llama,origin,1,1_1000#70,89,1000,1089,0,LLAMA3/origin/MATH500/1_1000.jsonl,70
Llama,origin,1,1_1000#71,53,142,195,1,LLAMA3/origin/MATH500/1_1000.jsonl,71
Llama,origin,1,1_1000#72,53,194,247,0,LLAMA3/origin/MATH500/1_1000.jsonl,72
Llama,origin,1,1_1000#73,67,226,293,1,LLAMA3/origin/MATH500/1_1000.jsonl,73
Llama,origin,1,1_1000#74,104,317,421,1,LLAMA3/origin/MATH500/1_1000.jsonl,74
Llama,origin,1,1_1000#75,60,215,275,0,LLAMA3/origin/MATH500/1_1000.jsonl,75
Llama,origin,1,1_1000#76,71,295,366,0,LLAMA3/origin/MATH500/1_1000.jsonl,76
Llama,origin,1,1_1000#77,73,148,221,1,LLAMA3/origin/MATH500/1_1000.jsonl,77
Llama,origin,1,1_1000#78,52,111,163,1,LLAMA3/origin/MATH500/1_1000.jsonl,78
Llama,origin,1,1_1000#79,102,506,608,0,LLAMA3/origin/MATH500/1_1000.jsonl,79
Llama,origin,1,1_1000#80,54,83,137,0,LLAMA3/origin/MATH500/1_1000.jsonl,80
Llama,origin,1,1_1000#81,75,239,314,1,LLAMA3/origin/MATH500/1_1000.jsonl,81
Llama,origin,1,1_1000#82,82,440,522,0,LLAMA3/origin/MATH500/1_1000.jsonl,82
Llama,origin,1,1_1000#83,120,431,551,0,LLAMA3/origin/MATH500/1_1000.jsonl,83
Llama,origin,1,1_1000#84,55,753,808,0,LLAMA3/origin/MATH500/1_1000.jsonl,84
Llama,origin,1,1_1000#85,86,340,426,1,LLAMA3/origin/MATH500/1_1000.jsonl,85
Llama,origin,1,1_1000#86,93,295,388,1,LLAMA3/origin/MATH500/1_1000.jsonl,86
Llama,origin,1,1_1000#87,71,115,186,0,LLAMA3/origin/MATH500/1_1000.jsonl,87
Llama,origin,1,1_1000#88,57,190,247,1,LLAMA3/origin/MATH500/1_1000.jsonl,88
Llama,origin,1,1_1000#89,120,525,645,0,LLAMA3/origin/MATH500/1_1000.jsonl,89
Llama,origin,1,1_1000#90,53,207,260,0,LLAMA3/origin/MATH500/1_1000.jsonl,90
Llama,origin,1,1_1000#91,74,87,161,0,LLAMA3/origin/MATH500/1_1000.jsonl,91
Llama,origin,1,1_1000#92,76,229,305,0,LLAMA3/origin/MATH500/1_1000.jsonl,92
Llama,origin,1,1_1000#93,73,174,247,1,LLAMA3/origin/MATH500/1_1000.jsonl,93
Llama,origin,1,1_1000#94,75,418,493,1,LLAMA3/origin/MATH500/1_1000.jsonl,94
Llama,origin,1,1_1000#95,375,270,645,0,LLAMA3/origin/MATH500/1_1000.jsonl,95
Llama,origin,1,1_1000#96,113,210,323,0,LLAMA3/origin/MATH500/1_1000.jsonl,96
Llama,origin,1,1_1000#97,137,535,672,0,LLAMA3/origin/MATH500/1_1000.jsonl,97
Llama,origin,1,1_1000#98,76,407,483,0,LLAMA3/origin/MATH500/1_1000.jsonl,98
Llama,origin,1,1_1000#99,51,147,198,0,LLAMA3/origin/MATH500/1_1000.jsonl,99
Llama,origin,1,1_1000#100,130,1000,1130,0,LLAMA3/origin/MATH500/1_1000.jsonl,100
Llama,origin,3,3_1000#1,81,308,389,0,LLAMA3/origin/MATH500/3_1000.jsonl,1
Llama,origin,3,3_1000#2,144,1000,1144,0,LLAMA3/origin/MATH500/3_1000.jsonl,2
Llama,origin,3,3_1000#3,80,449,529,1,LLAMA3/origin/MATH500/3_1000.jsonl,3
Llama,origin,3,3_1000#4,45,115,160,0,LLAMA3/origin/MATH500/3_1000.jsonl,4
Llama,origin,3,3_1000#5,360,404,764,0,LLAMA3/origin/MATH500/3_1000.jsonl,5
Llama,origin,3,3_1000#6,73,107,180,0,LLAMA3/origin/MATH500/3_1000.jsonl,6
Llama,origin,3,3_1000#7,52,783,835,0,LLAMA3/origin/MATH500/3_1000.jsonl,7
Llama,origin,3,3_1000#8,99,892,991,0,LLAMA3/origin/MATH500/3_1000.jsonl,8
Llama,origin,3,3_1000#9,67,198,265,0,LLAMA3/origin/MATH500/3_1000.jsonl,9
Llama,origin,3,3_1000#10,174,1000,1174,0,LLAMA3/origin/MATH500/3_1000.jsonl,10
Llama,origin,3,3_1000#11,57,334,391,0,LLAMA3/origin/MATH500/3_1000.jsonl,11
Llama,origin,3,3_1000#12,92,694,786,0,LLAMA3/origin/MATH500/3_1000.jsonl,12
Llama,origin,3,3_1000#13,101,239,340,1,LLAMA3/origin/MATH500/3_1000.jsonl,13
Llama,origin,3,3_1000#14,204,203,407,1,LLAMA3/origin/MATH500/3_1000.jsonl,14
Llama,origin,3,3_1000#15,144,270,414,0,LLAMA3/origin/MATH500/3_1000.jsonl,15
Llama,origin,3,3_1000#16,211,1000,1211,0,LLAMA3/origin/MATH500/3_1000.jsonl,16
Llama,origin,3,3_1000#17,54,83,137,1,LLAMA3/origin/MATH500/3_1000.jsonl,17
Llama,origin,3,3_1000#18,240,1000,1240,0,LLAMA3/origin/MATH500/3_1000.jsonl,18
Llama,origin,3,3_1000#19,179,420,599,0,LLAMA3/origin/MATH500/3_1000.jsonl,19
Llama,origin,3,3_1000#20,81,790,871,0,LLAMA3/origin/MATH500/3_1000.jsonl,20
Llama,origin,3,3_1000#21,46,124,170,1,LLAMA3/origin/MATH500/3_1000.jsonl,21
Llama,origin,3,3_1000#22,62,818,880,0,LLAMA3/origin/MATH500/3_1000.jsonl,22
Llama,origin,3,3_1000#23,158,554,712,0,LLAMA3/origin/MATH500/3_1000.jsonl,23
Llama,origin,3,3_1000#24,61,482,543,0,LLAMA3/origin/MATH500/3_1000.jsonl,24
Llama,origin,3,3_1000#25,130,408,538,1,LLAMA3/origin/MATH500/3_1000.jsonl,25
Llama,origin,3,3_1000#26,112,634,746,0,LLAMA3/origin/MATH500/3_1000.jsonl,26
Llama,origin,3,3_1000#27,85,423,508,0,LLAMA3/origin/MATH500/3_1000.jsonl,27
Llama,origin,3,3_1000#28,110,244,354,0,LLAMA3/origin/MATH500/3_1000.jsonl,28
Llama,origin,3,3_1000#29,67,116,183,1,LLAMA3/origin/MATH500/3_1000.jsonl,29
Llama,origin,3,3_1000#30,110,239,349,0,LLAMA3/origin/MATH500/3_1000.jsonl,30
Llama,origin,3,3_1000#31,57,127,184,1,LLAMA3/origin/MATH500/3_1000.jsonl,31
Llama,origin,3,3_1000#32,41,157,198,0,LLAMA3/origin/MATH500/3_1000.jsonl,32
Llama,origin,3,3_1000#33,84,207,291,0,LLAMA3/origin/MATH500/3_1000.jsonl,33
Llama,origin,3,3_1000#34,78,407,485,0,LLAMA3/origin/MATH500/3_1000.jsonl,34
Llama,origin,3,3_1000#35,66,696,762,1,LLAMA3/origin/MATH500/3_1000.jsonl,35
Llama,origin,3,3_1000#36,74,320,394,1,LLAMA3/origin/MATH500/3_1000.jsonl,36
Llama,origin,3,3_1000#37,62,852,914,0,LLAMA3/origin/MATH500/3_1000.jsonl,37
Llama,origin,3,3_1000#38,67,235,302,0,LLAMA3/origin/MATH500/3_1000.jsonl,38
Llama,origin,3,3_1000#39,74,230,304,0,LLAMA3/origin/MATH500/3_1000.jsonl,39
Llama,origin,3,3_1000#40,55,229,284,0,LLAMA3/origin/MATH500/3_1000.jsonl,40
Llama,origin,3,3_1000#41,130,154,284,1,LLAMA3/origin/MATH500/3_1000.jsonl,41
Llama,origin,3,3_1000#42,83,320,403,0,LLAMA3/origin/MATH500/3_1000.jsonl,42
Llama,origin,3,3_1000#43,73,301,374,0,LLAMA3/origin/MATH500/3_1000.jsonl,43
Llama,origin,3,3_1000#44,107,1000,1107,0,LLAMA3/origin/MATH500/3_1000.jsonl,44
Llama,origin,3,3_1000#45,97,405,502,0,LLAMA3/origin/MATH500/3_1000.jsonl,45
Llama,origin,3,3_1000#46,69,59,128,1,LLAMA3/origin/MATH500/3_1000.jsonl,46
Llama,origin,3,3_1000#47,77,880,957,0,LLAMA3/origin/MATH500/3_1000.jsonl,47
Llama,origin,3,3_1000#48,84,275,359,1,LLAMA3/origin/MATH500/3_1000.jsonl,48
Llama,origin,3,3_1000#49,52,464,516,1,LLAMA3/origin/MATH500/3_1000.jsonl,49
Llama,origin,3,3_1000#50,58,175,233,1,LLAMA3/origin/MATH500/3_1000.jsonl,50
Llama,origin,3,3_1000#51,129,535,664,0,LLAMA3/origin/MATH500/3_1000.jsonl,51
Llama,origin,3,3_1000#52,55,745,800,1,LLAMA3/origin/MATH500/3_1000.jsonl,52
Llama,origin,3,3_1000#53,63,174,237,1,LLAMA3/origin/MATH500/3_1000.jsonl,53
Llama,origin,3,3_1000#54,60,76,136,1,LLAMA3/origin/MATH500/3_1000.jsonl,54
Llama,origin,3,3_1000#55,45,76,121,0,LLAMA3/origin/MATH500/3_1000.jsonl,55
Llama,origin,3,3_1000#56,83,268,351,0,LLAMA3/origin/MATH500/3_1000.jsonl,56
Llama,origin,3,3_1000#57,57,118,175,0,LLAMA3/origin/MATH500/3_1000.jsonl,57
Llama,origin,3,3_1000#58,87,548,635,0,LLAMA3/origin/MATH500/3_1000.jsonl,58
Llama,origin,3,3_1000#59,47,205,252,0,LLAMA3/origin/MATH500/3_1000.jsonl,59
Llama,origin,3,3_1000#60,79,294,373,0,LLAMA3/origin/MATH500/3_1000.jsonl,60
Llama,origin,3,3_1000#61,83,1000,1083,0,LLAMA3/origin/MATH500/3_1000.jsonl,61
Llama,origin,3,3_1000#62,102,212,314,1,LLAMA3/origin/MATH500/3_1000.jsonl,62
Llama,origin,3,3_1000#63,139,675,814,0,LLAMA3/origin/MATH500/3_1000.jsonl,63
Llama,origin,3,3_1000#64,122,460,582,0,LLAMA3/origin/MATH500/3_1000.jsonl,64
Llama,origin,3,3_1000#65,99,635,734,0,LLAMA3/origin/MATH500/3_1000.jsonl,65
Llama,origin,3,3_1000#66,47,159,206,1,LLAMA3/origin/MATH500/3_1000.jsonl,66
Llama,origin,3,3_1000#67,71,346,417,0,LLAMA3/origin/MATH500/3_1000.jsonl,67
Llama,origin,3,3_1000#68,81,227,308,0,LLAMA3/origin/MATH500/3_1000.jsonl,68
Llama,origin,3,3_1000#69,94,1000,1094,0,LLAMA3/origin/MATH500/3_1000.jsonl,69
Llama,origin,3,3_1000#70,89,903,992,0,LLAMA3/origin/MATH500/3_1000.jsonl,70
Llama,origin,3,3_1000#71,53,303,356,1,LLAMA3/origin/MATH500/3_1000.jsonl,71
Llama,origin,3,3_1000#72,53,158,211,0,LLAMA3/origin/MATH500/3_1000.jsonl,72
Llama,origin,3,3_1000#73,67,226,293,1,LLAMA3/origin/MATH500/3_1000.jsonl,73
Llama,origin,3,3_1000#74,104,325,429,1,LLAMA3/origin/MATH500/3_1000.jsonl,74
Llama,origin,3,3_1000#75,60,422,482,0,LLAMA3/origin/MATH500/3_1000.jsonl,75
Llama,origin,3,3_1000#76,71,456,527,0,LLAMA3/origin/MATH500/3_1000.jsonl,76
Llama,origin,3,3_1000#77,73,113,186,1,LLAMA3/origin/MATH500/3_1000.jsonl,77
Llama,origin,3,3_1000#78,52,90,142,1,LLAMA3/origin/MATH500/3_1000.jsonl,78
Llama,origin,3,3_1000#79,102,1000,1102,0,LLAMA3/origin/MATH500/3_1000.jsonl,79
Llama,origin,3,3_1000#80,54,63,117,1,LLAMA3/origin/MATH500/3_1000.jsonl,80
Llama,origin,3,3_1000#81,75,1000,1075,0,LLAMA3/origin/MATH500/3_1000.jsonl,81
Llama,origin,3,3_1000#82,82,293,375,0,LLAMA3/origin/MATH500/3_1000.jsonl,82
Llama,origin,3,3_1000#83,120,609,729,1,LLAMA3/origin/MATH500/3_1000.jsonl,83
Llama,origin,3,3_1000#84,55,790,845,0,LLAMA3/origin/MATH500/3_1000.jsonl,84
Llama,origin,3,3_1000#85,86,484,570,1,LLAMA3/origin/MATH500/3_1000.jsonl,85
Llama,origin,3,3_1000#86,93,283,376,1,LLAMA3/origin/MATH500/3_1000.jsonl,86
Llama,origin,3,3_1000#87,71,101,172,0,LLAMA3/origin/MATH500/3_1000.jsonl,87
Llama,origin,3,3_1000#88,57,144,201,0,LLAMA3/origin/MATH500/3_1000.jsonl,88
Llama,origin,3,3_1000#89,120,506,626,1,LLAMA3/origin/MATH500/3_1000.jsonl,89
Llama,origin,3,3_1000#90,53,210,263,0,LLAMA3/origin/MATH500/3_1000.jsonl,90
Llama,origin,3,3_1000#91,74,88,162,0,LLAMA3/origin/MATH500/3_1000.jsonl,91
Llama,origin,3,3_1000#92,76,263,339,0,LLAMA3/origin/MATH500/3_1000.jsonl,92
Llama,origin,3,3_1000#93,73,285,358,1,LLAMA3/origin/MATH500/3_1000.jsonl,93
Llama,origin,3,3_1000#94,75,468,543,1,LLAMA3/origin/MATH500/3_1000.jsonl,94
Llama,origin,3,3_1000#95,375,646,1021,0,LLAMA3/origin/MATH500/3_1000.jsonl,95
Llama,origin,3,3_1000#96,113,439,552,0,LLAMA3/origin/MATH500/3_1000.jsonl,96
Llama,origin,3,3_1000#97,137,1000,1137,0,LLAMA3/origin/MATH500/3_1000.jsonl,97
Llama,origin,3,3_1000#98,76,212,288,0,LLAMA3/origin/MATH500/3_1000.jsonl,98
Llama,origin,3,3_1000#99,51,110,161,0,LLAMA3/origin/MATH500/3_1000.jsonl,99
Llama,origin,3,3_1000#100,130,616,746,0,LLAMA3/origin/MATH500/3_1000.jsonl,100
Llama,origin,9,9_1000#1,81,289,370,0,LLAMA3/origin/MATH500/9_1000.jsonl,1
Llama,origin,9,9_1000#2,144,1000,1144,0,LLAMA3/origin/MATH500/9_1000.jsonl,2
Llama,origin,9,9_1000#3,80,403,483,1,LLAMA3/origin/MATH500/9_1000.jsonl,3
Llama,origin,9,9_1000#4,45,138,183,0,LLAMA3/origin/MATH500/9_1000.jsonl,4
Llama,origin,9,9_1000#5,360,331,691,0,LLAMA3/origin/MATH500/9_1000.jsonl,5
Llama,origin,9,9_1000#6,73,127,200,0,LLAMA3/origin/MATH500/9_1000.jsonl,6
Llama,origin,9,9_1000#7,52,761,813,0,LLAMA3/origin/MATH500/9_1000.jsonl,7
Llama,origin,9,9_1000#8,99,1000,1099,0,LLAMA3/origin/MATH500/9_1000.jsonl,8
Llama,origin,9,9_1000#9,67,260,327,1,LLAMA3/origin/MATH500/9_1000.jsonl,9
Llama,origin,9,9_1000#10,174,688,862,0,LLAMA3/origin/MATH500/9_1000.jsonl,10
Llama,origin,9,9_1000#11,57,209,266,0,LLAMA3/origin/MATH500/9_1000.jsonl,11
Llama,origin,9,9_1000#12,92,1000,1092,0,LLAMA3/origin/MATH500/9_1000.jsonl,12
Llama,origin,9,9_1000#13,101,239,340,1,LLAMA3/origin/MATH500/9_1000.jsonl,13
Llama,origin,9,9_1000#14,204,176,380,1,LLAMA3/origin/MATH500/9_1000.jsonl,14
Llama,origin,9,9_1000#15,144,309,453,0,LLAMA3/origin/MATH500/9_1000.jsonl,15
Llama,origin,9,9_1000#16,211,972,1183,1,LLAMA3/origin/MATH500/9_1000.jsonl,16
Llama,origin,9,9_1000#17,54,356,410,1,LLAMA3/origin/MATH500/9_1000.jsonl,17
Llama,origin,9,9_1000#18,240,562,802,0,LLAMA3/origin/MATH500/9_1000.jsonl,18
Llama,origin,9,9_1000#19,179,1000,1179,0,LLAMA3/origin/MATH500/9_1000.jsonl,19
Llama,origin,9,9_1000#20,81,480,561,1,LLAMA3/origin/MATH500/9_1000.jsonl,20
Llama,origin,9,9_1000#21,46,114,160,0,LLAMA3/origin/MATH500/9_1000.jsonl,21
Llama,origin,9,9_1000#22,62,1000,1062,0,LLAMA3/origin/MATH500/9_1000.jsonl,22
Llama,origin,9,9_1000#23,158,550,708,1,LLAMA3/origin/MATH500/9_1000.jsonl,23
Llama,origin,9,9_1000#24,61,604,665,0,LLAMA3/origin/MATH500/9_1000.jsonl,24
Llama,origin,9,9_1000#25,130,425,555,1,LLAMA3/origin/MATH500/9_1000.jsonl,25
Llama,origin,9,9_1000#26,112,1000,1112,0,LLAMA3/origin/MATH500/9_1000.jsonl,26
Llama,origin,9,9_1000#27,85,379,464,0,LLAMA3/origin/MATH500/9_1000.jsonl,27
Llama,origin,9,9_1000#28,110,238,348,0,LLAMA3/origin/MATH500/9_1000.jsonl,28
Llama,origin,9,9_1000#29,67,179,246,1,LLAMA3/origin/MATH500/9_1000.jsonl,29
Llama,origin,9,9_1000#30,110,250,360,0,LLAMA3/origin/MATH500/9_1000.jsonl,30
Llama,origin,9,9_1000#31,57,390,447,0,LLAMA3/origin/MATH500/9_1000.jsonl,31
Llama,origin,9,9_1000#32,41,157,198,0,LLAMA3/origin/MATH500/9_1000.jsonl,32
Llama,origin,9,9_1000#33,84,211,295,1,LLAMA3/origin/MATH500/9_1000.jsonl,33
Llama,origin,9,9_1000#34,78,490,568,1,LLAMA3/origin/MATH500/9_1000.jsonl,34
Llama,origin,9,9_1000#35,66,652,718,0,LLAMA3/origin/MATH500/9_1000.jsonl,35
Llama,origin,9,9_1000#36,74,162,236,1,LLAMA3/origin/MATH500/9_1000.jsonl,36
Llama,origin,9,9_1000#37,62,726,788,0,LLAMA3/origin/MATH500/9_1000.jsonl,37
Llama,origin,9,9_1000#38,67,244,311,0,LLAMA3/origin/MATH500/9_1000.jsonl,38
Llama,origin,9,9_1000#39,74,176,250,0,LLAMA3/origin/MATH500/9_1000.jsonl,39
Llama,origin,9,9_1000#40,55,302,357,0,LLAMA3/origin/MATH500/9_1000.jsonl,40
Llama,origin,9,9_1000#41,130,190,320,1,LLAMA3/origin/MATH500/9_1000.jsonl,41
Llama,origin,9,9_1000#42,83,318,401,0,LLAMA3/origin/MATH500/9_1000.jsonl,42
Llama,origin,9,9_1000#43,73,302,375,0,LLAMA3/origin/MATH500/9_1000.jsonl,43
Llama,origin,9,9_1000#44,107,1000,1107,0,LLAMA3/origin/MATH500/9_1000.jsonl,44
Llama,origin,9,9_1000#45,97,408,505,1,LLAMA3/origin/MATH500/9_1000.jsonl,45
Llama,origin,9,9_1000#46,69,501,570,1,LLAMA3/origin/MATH500/9_1000.jsonl,46
Llama,origin,9,9_1000#47,77,486,563,0,LLAMA3/origin/MATH500/9_1000.jsonl,47
Llama,origin,9,9_1000#48,84,274,358,1,LLAMA3/origin/MATH500/9_1000.jsonl,48
Llama,origin,9,9_1000#49,52,350,402,1,LLAMA3/origin/MATH500/9_1000.jsonl,49
Llama,origin,9,9_1000#50,58,181,239,1,LLAMA3/origin/MATH500/9_1000.jsonl,50
Llama,origin,9,9_1000#51,129,488,617,0,LLAMA3/origin/MATH500/9_1000.jsonl,51
Llama,origin,9,9_1000#52,55,829,884,1,LLAMA3/origin/MATH500/9_1000.jsonl,52
Llama,origin,9,9_1000#53,63,127,190,1,LLAMA3/origin/MATH500/9_1000.jsonl,53
Llama,origin,9,9_1000#54,60,75,135,1,LLAMA3/origin/MATH500/9_1000.jsonl,54
Llama,origin,9,9_1000#55,45,76,121,0,LLAMA3/origin/MATH500/9_1000.jsonl,55
Llama,origin,9,9_1000#56,83,257,340,0,LLAMA3/origin/MATH500/9_1000.jsonl,56
Llama,origin,9,9_1000#57,57,126,183,1,LLAMA3/origin/MATH500/9_1000.jsonl,57
Llama,origin,9,9_1000#58,87,548,635,0,LLAMA3/origin/MATH500/9_1000.jsonl,58
Llama,origin,9,9_1000#59,47,152,199,0,LLAMA3/origin/MATH500/9_1000.jsonl,59
Llama,origin,9,9_1000#60,79,385,464,0,LLAMA3/origin/MATH500/9_1000.jsonl,60
Llama,origin,9,9_1000#61,83,1000,1083,0,LLAMA3/origin/MATH500/9_1000.jsonl,61
Llama,origin,9,9_1000#62,102,601,703,1,LLAMA3/origin/MATH500/9_1000.jsonl,62
Llama,origin,9,9_1000#63,139,1000,1139,0,LLAMA3/origin/MATH500/9_1000.jsonl,63
Llama,origin,9,9_1000#64,122,820,942,1,LLAMA3/origin/MATH500/9_1000.jsonl,64
Llama,origin,9,9_1000#65,99,1000,1099,0,LLAMA3/origin/MATH500/9_1000.jsonl,65
Llama,origin,9,9_1000#66,47,131,178,1,LLAMA3/origin/MATH500/9_1000.jsonl,66
Llama,origin,9,9_1000#67,71,160,231,1,LLAMA3/origin/MATH500/9_1000.jsonl,67
Llama,origin,9,9_1000#68,81,227,308,0,LLAMA3/origin/MATH500/9_1000.jsonl,68
Llama,origin,9,9_1000#69,94,1000,1094,0,LLAMA3/origin/MATH500/9_1000.jsonl,69
Llama,origin,9,9_1000#70,89,1000,1089,0,LLAMA3/origin/MATH500/9_1000.jsonl,70
Llama,origin,9,9_1000#71,53,303,356,1,LLAMA3/origin/MATH500/9_1000.jsonl,71
Llama,origin,9,9_1000#72,53,158,211,0,LLAMA3/origin/MATH500/9_1000.jsonl,72
Llama,origin,9,9_1000#73,67,226,293,1,LLAMA3/origin/MATH500/9_1000.jsonl,73
Llama,origin,9,9_1000#74,104,319,423,1,LLAMA3/origin/MATH500/9_1000.jsonl,74
Llama,origin,9,9_1000#75,60,204,264,0,LLAMA3/origin/MATH500/9_1000.jsonl,75
Llama,origin,9,9_1000#76,71,480,551,1,LLAMA3/origin/MATH500/9_1000.jsonl,76
Llama,origin,9,9_1000#77,73,171,244,1,LLAMA3/origin/MATH500/9_1000.jsonl,77
Llama,origin,9,9_1000#78,52,128,180,1,LLAMA3/origin/MATH500/9_1000.jsonl,78
Llama,origin,9,9_1000#79,102,975,1077,0,LLAMA3/origin/MATH500/9_1000.jsonl,79
Llama,origin,9,9_1000#80,54,65,119,1,LLAMA3/origin/MATH500/9_1000.jsonl,80
Llama,origin,9,9_1000#81,75,619,694,0,LLAMA3/origin/MATH500/9_1000.jsonl,81
Llama,origin,9,9_1000#82,82,186,268,0,LLAMA3/origin/MATH500/9_1000.jsonl,82
Llama,origin,9,9_1000#83,120,377,497,0,LLAMA3/origin/MATH500/9_1000.jsonl,83
Llama,origin,9,9_1000#84,55,911,966,0,LLAMA3/origin/MATH500/9_1000.jsonl,84
Llama,origin,9,9_1000#85,86,634,720,1,LLAMA3/origin/MATH500/9_1000.jsonl,85
Llama,origin,9,9_1000#86,93,255,348,1,LLAMA3/origin/MATH500/9_1000.jsonl,86
Llama,origin,9,9_1000#87,71,101,172,0,LLAMA3/origin/MATH500/9_1000.jsonl,87
Llama,origin,9,9_1000#88,57,291,348,1,LLAMA3/origin/MATH500/9_1000.jsonl,88
Llama,origin,9,9_1000#89,120,1000,1120,0,LLAMA3/origin/MATH500/9_1000.jsonl,89
Llama,origin,9,9_1000#90,53,378,431,0,LLAMA3/origin/MATH500/9_1000.jsonl,90
Llama,origin,9,9_1000#91,74,134,208,0,LLAMA3/origin/MATH500/9_1000.jsonl,91
Llama,origin,9,9_1000#92,76,429,505,0,LLAMA3/origin/MATH500/9_1000.jsonl,92
Llama,origin,9,9_1000#93,73,464,537,0,LLAMA3/origin/MATH500/9_1000.jsonl,93
Llama,origin,9,9_1000#94,75,455,530,1,LLAMA3/origin/MATH500/9_1000.jsonl,94
Llama,origin,9,9_1000#95,375,166,541,0,LLAMA3/origin/MATH500/9_1000.jsonl,95
Llama,origin,9,9_1000#96,113,1000,1113,0,LLAMA3/origin/MATH500/9_1000.jsonl,96
Llama,origin,9,9_1000#97,137,1000,1137,0,LLAMA3/origin/MATH500/9_1000.jsonl,97
Llama,origin,9,9_1000#98,76,208,284,0,LLAMA3/origin/MATH500/9_1000.jsonl,98
Llama,origin,9,9_1000#99,51,161,212,0,LLAMA3/origin/MATH500/9_1000.jsonl,99
Llama,origin,9,9_1000#100,130,1000,1130,0,LLAMA3/origin/MATH500/9_1000.jsonl,100
Llama,tree,15,15_1000#1,81,289,370,0,LLAMA3/tree/MATH500/15_1000.jsonl,1
Llama,tree,15,15_1000#2,144,1001,1145,0,LLAMA3/tree/MATH500/15_1000.jsonl,2
Llama,tree,15,15_1000#3,80,553,633,1,LLAMA3/tree/MATH500/15_1000.jsonl,3
Llama,tree,15,15_1000#4,45,143,188,0,LLAMA3/tree/MATH500/15_1000.jsonl,4
Llama,tree,15,15_1000#5,360,331,691,0,LLAMA3/tree/MATH500/15_1000.jsonl,5
Llama,tree,15,15_1000#6,73,127,200,0,LLAMA3/tree/MATH500/15_1000.jsonl,6
Llama,tree,15,15_1000#7,52,462,514,1,LLAMA3/tree/MATH500/15_1000.jsonl,7
Llama,tree,15,15_1000#8,99,1001,1100,0,LLAMA3/tree/MATH500/15_1000.jsonl,8
Llama,tree,15,15_1000#9,67,260,327,1,LLAMA3/tree/MATH500/15_1000.jsonl,9
Llama,tree,15,15_1000#10,174,652,826,0,LLAMA3/tree/MATH500/15_1000.jsonl,10
Llama,tree,15,15_1000#11,57,368,425,0,LLAMA3/tree/MATH500/15_1000.jsonl,11
Llama,tree,15,15_1000#12,92,1001,1093,0,LLAMA3/tree/MATH500/15_1000.jsonl,12
Llama,tree,15,15_1000#13,101,211,312,1,LLAMA3/tree/MATH500/15_1000.jsonl,13
Llama,tree,15,15_1000#14,204,173,377,1,LLAMA3/tree/MATH500/15_1000.jsonl,14
Llama,tree,15,15_1000#15,144,305,449,0,LLAMA3/tree/MATH500/15_1000.jsonl,15
Llama,tree,15,15_1000#16,211,1001,1212,0,LLAMA3/tree/MATH500/15_1000.jsonl,16
Llama,tree,15,15_1000#17,54,354,408,1,LLAMA3/tree/MATH500/15_1000.jsonl,17
Llama,tree,15,15_1000#18,240,639,879,0,LLAMA3/tree/MATH500/15_1000.jsonl,18
Llama,tree,15,15_1000#19,179,324,503,1,LLAMA3/tree/MATH500/15_1000.jsonl,19
Llama,tree,15,15_1000#20,81,481,562,1,LLAMA3/tree/MATH500/15_1000.jsonl,20
Llama,tree,15,15_1000#21,46,127,173,0,LLAMA3/tree/MATH500/15_1000.jsonl,21
Llama,tree,15,15_1000#22,62,1001,1063,0,LLAMA3/tree/MATH500/15_1000.jsonl,22
Llama,tree,15,15_1000#23,158,579,737,1,LLAMA3/tree/MATH500/15_1000.jsonl,23
Llama,tree,15,15_1000#24,61,604,665,0,LLAMA3/tree/MATH500/15_1000.jsonl,24
Llama,tree,15,15_1000#25,130,448,578,1,LLAMA3/tree/MATH500/15_1000.jsonl,25
Llama,tree,15,15_1000#26,112,1001,1113,0,LLAMA3/tree/MATH500/15_1000.jsonl,26
Llama,tree,15,15_1000#27,85,379,464,0,LLAMA3/tree/MATH500/15_1000.jsonl,27
Llama,tree,15,15_1000#28,110,219,329,0,LLAMA3/tree/MATH500/15_1000.jsonl,28
Llama,tree,15,15_1000#29,67,205,272,1,LLAMA3/tree/MATH500/15_1000.jsonl,29
Llama,tree,15,15_1000#30,110,252,362,0,LLAMA3/tree/MATH500/15_1000.jsonl,30
Llama,tree,15,15_1000#31,57,385,442,0,LLAMA3/tree/MATH500/15_1000.jsonl,31
Llama,tree,15,15_1000#32,41,157,198,0,LLAMA3/tree/MATH500/15_1000.jsonl,32
Llama,tree,15,15_1000#33,84,211,295,1,LLAMA3/tree/MATH500/15_1000.jsonl,33
Llama,tree,15,15_1000#34,78,482,560,1,LLAMA3/tree/MATH500/15_1000.jsonl,34
Llama,tree,15,15_1000#35,66,605,671,1,LLAMA3/tree/MATH500/15_1000.jsonl,35
Llama,tree,15,15_1000#36,74,162,236,1,LLAMA3/tree/MATH500/15_1000.jsonl,36
Llama,tree,15,15_1000#37,62,1001,1063,0,LLAMA3/tree/MATH500/15_1000.jsonl,37
Llama,tree,15,15_1000#38,67,249,316,0,LLAMA3/tree/MATH500/15_1000.jsonl,38
Llama,tree,15,15_1000#39,74,224,298,0,LLAMA3/tree/MATH500/15_1000.jsonl,39
Llama,tree,15,15_1000#40,55,232,287,1,LLAMA3/tree/MATH500/15_1000.jsonl,40
Llama,tree,15,15_1000#41,130,130,260,1,LLAMA3/tree/MATH500/15_1000.jsonl,41
Llama,tree,15,15_1000#42,83,318,401,0,LLAMA3/tree/MATH500/15_1000.jsonl,42
Llama,tree,15,15_1000#43,73,314,387,0,LLAMA3/tree/MATH500/15_1000.jsonl,43
Llama,tree,15,15_1000#44,107,551,658,0,LLAMA3/tree/MATH500/15_1000.jsonl,44
Llama,tree,15,15_1000#45,97,408,505,1,LLAMA3/tree/MATH500/15_1000.jsonl,45
Llama,tree,15,15_1000#46,69,177,246,0,LLAMA3/tree/MATH500/15_1000.jsonl,46
Llama,tree,15,15_1000#47,77,474,551,0,LLAMA3/tree/MATH500/15_1000.jsonl,47
Llama,tree,15,15_1000#48,84,350,434,1,LLAMA3/tree/MATH500/15_1000.jsonl,48
Llama,tree,15,15_1000#49,52,199,251,1,LLAMA3/tree/MATH500/15_1000.jsonl,49
Llama,tree,15,15_1000#50,58,217,275,1,LLAMA3/tree/MATH500/15_1000.jsonl,50
Llama,tree,15,15_1000#51,129,255,384,0,LLAMA3/tree/MATH500/15_1000.jsonl,51
Llama,tree,15,15_1000#52,55,829,884,1,LLAMA3/tree/MATH500/15_1000.jsonl,52
Llama,tree,15,15_1000#53,63,127,190,1,LLAMA3/tree/MATH500/15_1000.jsonl,53
Llama,tree,15,15_1000#54,60,75,135,1,LLAMA3/tree/MATH500/15_1000.jsonl,54
Llama,tree,15,15_1000#55,45,65,110,0,LLAMA3/tree/MATH500/15_1000.jsonl,55
Llama,tree,15,15_1000#56,83,228,311,0,LLAMA3/tree/MATH500/15_1000.jsonl,56
Llama,tree,15,15_1000#57,57,126,183,1,LLAMA3/tree/MATH500/15_1000.jsonl,57
Llama,tree,15,15_1000#58,87,548,635,0,LLAMA3/tree/MATH500/15_1000.jsonl,58
Llama,tree,15,15_1000#59,47,146,193,0,LLAMA3/tree/MATH500/15_1000.jsonl,59
Llama,tree,15,15_1000#60,79,335,414,0,LLAMA3/tree/MATH500/15_1000.jsonl,60
Llama,tree,15,15_1000#61,83,1001,1084,0,LLAMA3/tree/MATH500/15_1000.jsonl,61
Llama,tree,15,15_1000#62,102,375,477,1,LLAMA3/tree/MATH500/15_1000.jsonl,62
Llama,tree,15,15_1000#63,139,896,1035,0,LLAMA3/tree/MATH500/15_1000.jsonl,63
Llama,tree,15,15_1000#64,122,800,922,0,LLAMA3/tree/MATH500/15_1000.jsonl,64
Llama,tree,15,15_1000#65,99,886,985,0,LLAMA3/tree/MATH500/15_1000.jsonl,65
Llama,tree,15,15_1000#66,47,198,245,1,LLAMA3/tree/MATH500/15_1000.jsonl,66
Llama,tree,15,15_1000#67,71,160,231,1,LLAMA3/tree/MATH500/15_1000.jsonl,67
Llama,tree,15,15_1000#68,81,227,308,0,LLAMA3/tree/MATH500/15_1000.jsonl,68
Llama,tree,15,15_1000#69,94,1001,1095,0,LLAMA3/tree/MATH500/15_1000.jsonl,69
Llama,tree,15,15_1000#70,89,1001,1090,0,LLAMA3/tree/MATH500/15_1000.jsonl,70
Llama,tree,15,15_1000#71,53,146,199,1,LLAMA3/tree/MATH500/15_1000.jsonl,71
Llama,tree,15,15_1000#72,53,229,282,0,LLAMA3/tree/MATH500/15_1000.jsonl,72
Llama,tree,15,15_1000#73,67,228,295,1,LLAMA3/tree/MATH500/15_1000.jsonl,73
Llama,tree,15,15_1000#74,104,319,423,1,LLAMA3/tree/MATH500/15_1000.jsonl,74
Llama,tree,15,15_1000#75,60,204,264,0,LLAMA3/tree/MATH500/15_1000.jsonl,75
Llama,tree,15,15_1000#76,71,324,395,1,LLAMA3/tree/MATH500/15_1000.jsonl,76
Llama,tree,15,15_1000#77,73,171,244,1,LLAMA3/tree/MATH500/15_1000.jsonl,77
Llama,tree,15,15_1000#78,52,128,180,1,LLAMA3/tree/MATH500/15_1000.jsonl,78
Llama,tree,15,15_1000#79,102,1001,1103,0,LLAMA3/tree/MATH500/15_1000.jsonl,79
Llama,tree,15,15_1000#80,54,115,169,1,LLAMA3/tree/MATH500/15_1000.jsonl,80
Llama,tree,15,15_1000#81,75,1001,1076,0,LLAMA3/tree/MATH500/15_1000.jsonl,81
Llama,tree,15,15_1000#82,82,186,268,0,LLAMA3/tree/MATH500/15_1000.jsonl,82
Llama,tree,15,15_1000#83,120,420,540,0,LLAMA3/tree/MATH500/15_1000.jsonl,83
Llama,tree,15,15_1000#84,55,1001,1056,0,LLAMA3/tree/MATH500/15_1000.jsonl,84
Llama,tree,15,15_1000#85,86,390,476,1,LLAMA3/tree/MATH500/15_1000.jsonl,85
Llama,tree,15,15_1000#86,93,341,434,1,LLAMA3/tree/MATH500/15_1000.jsonl,86
Llama,tree,15,15_1000#87,71,105,176,0,LLAMA3/tree/MATH500/15_1000.jsonl,87
Llama,tree,15,15_1000#88,57,297,354,1,LLAMA3/tree/MATH500/15_1000.jsonl,88
Llama,tree,15,15_1000#89,120,1001,1121,0,LLAMA3/tree/MATH500/15_1000.jsonl,89
Llama,tree,15,15_1000#90,53,378,431,0,LLAMA3/tree/MATH500/15_1000.jsonl,90
Llama,tree,15,15_1000#91,74,134,208,0,LLAMA3/tree/MATH500/15_1000.jsonl,91
Llama,tree,15,15_1000#92,76,299,375,0,LLAMA3/tree/MATH500/15_1000.jsonl,92
Llama,tree,15,15_1000#93,73,464,537,0,LLAMA3/tree/MATH500/15_1000.jsonl,93
Llama,tree,15,15_1000#94,75,455,530,1,LLAMA3/tree/MATH500/15_1000.jsonl,94
Llama,tree,15,15_1000#95,375,1001,1376,0,LLAMA3/tree/MATH500/15_1000.jsonl,95
Llama,tree,15,15_1000#96,113,734,847,1,LLAMA3/tree/MATH500/15_1000.jsonl,96
Llama,tree,15,15_1000#97,137,1001,1138,0,LLAMA3/tree/MATH500/15_1000.jsonl,97
Llama,tree,15,15_1000#98,76,198,274,0,LLAMA3/tree/MATH500/15_1000.jsonl,98
Llama,tree,15,15_1000#99,51,156,207,0,LLAMA3/tree/MATH500/15_1000.jsonl,99
Llama,tree,15,15_1000#100,130,1001,1131,0,LLAMA3/tree/MATH500/15_1000.jsonl,100
Llama,tree,3,3_1000#1,81,308,389,0,LLAMA3/tree/MATH500/3_1000.jsonl,1
Llama,tree,3,3_1000#2,144,1001,1145,0,LLAMA3/tree/MATH500/3_1000.jsonl,2
Llama,tree,3,3_1000#3,80,449,529,1,LLAMA3/tree/MATH500/3_1000.jsonl,3
Llama,tree,3,3_1000#4,45,115,160,0,LLAMA3/tree/MATH500/3_1000.jsonl,4
Llama,tree,3,3_1000#5,360,404,764,0,LLAMA3/tree/MATH500/3_1000.jsonl,5
Llama,tree,3,3_1000#6,73,107,180,0,LLAMA3/tree/MATH500/3_1000.jsonl,6
Llama,tree,3,3_1000#7,52,783,835,0,LLAMA3/tree/MATH500/3_1000.jsonl,7
Llama,tree,3,3_1000#8,99,892,991,0,LLAMA3/tree/MATH500/3_1000.jsonl,8
Llama,tree,3,3_1000#9,67,198,265,0,LLAMA3/tree/MATH500/3_1000.jsonl,9
Llama,tree,3,3_1000#10,174,1001,1175,0,LLAMA3/tree/MATH500/3_1000.jsonl,10
Llama,tree,3,3_1000#11,57,334,391,0,LLAMA3/tree/MATH500/3_1000.jsonl,11
Llama,tree,3,3_1000#12,92,694,786,0,LLAMA3/tree/MATH500/3_1000.jsonl,12
Llama,tree,3,3_1000#13,101,239,340,1,LLAMA3/tree/MATH500/3_1000.jsonl,13
Llama,tree,3,3_1000#14,204,203,407,1,LLAMA3/tree/MATH500/3_1000.jsonl,14
Llama,tree,3,3_1000#15,144,279,423,0,LLAMA3/tree/MATH500/3_1000.jsonl,15
Llama,tree,3,3_1000#16,211,1001,1212,0,LLAMA3/tree/MATH500/3_1000.jsonl,16
Llama,tree,3,3_1000#17,54,83,137,1,LLAMA3/tree/MATH500/3_1000.jsonl,17
Llama,tree,3,3_1000#18,240,1001,1241,0,LLAMA3/tree/MATH500/3_1000.jsonl,18
Llama,tree,3,3_1000#19,179,420,599,0,LLAMA3/tree/MATH500/3_1000.jsonl,19
Llama,tree,3,3_1000#20,81,790,871,0,LLAMA3/tree/MATH500/3_1000.jsonl,20
Llama,tree,3,3_1000#21,46,124,170,1,LLAMA3/tree/MATH500/3_1000.jsonl,21
Llama,tree,3,3_1000#22,62,818,880,0,LLAMA3/tree/MATH500/3_1000.jsonl,22
Llama,tree,3,3_1000#23,158,554,712,0,LLAMA3/tree/MATH500/3_1000.jsonl,23
Llama,tree,3,3_1000#24,61,482,543,0,LLAMA3/tree/MATH500/3_1000.jsonl,24
Llama,tree,3,3_1000#25,130,408,538,1,LLAMA3/tree/MATH500/3_1000.jsonl,25
Llama,tree,3,3_1000#26,112,634,746,0,LLAMA3/tree/MATH500/3_1000.jsonl,26
Llama,tree,3,3_1000#27,85,423,508,0,LLAMA3/tree/MATH500/3_1000.jsonl,27
Llama,tree,3,3_1000#28,110,244,354,0,LLAMA3/tree/MATH500/3_1000.jsonl,28
Llama,tree,3,3_1000#29,67,116,183,1,LLAMA3/tree/MATH500/3_1000.jsonl,29
Llama,tree,3,3_1000#30,110,239,349,0,LLAMA3/tree/MATH500/3_1000.jsonl,30
Llama,tree,3,3_1000#31,57,127,184,1,LLAMA3/tree/MATH500/3_1000.jsonl,31
Llama,tree,3,3_1000#32,41,157,198,0,LLAMA3/tree/MATH500/3_1000.jsonl,32
Llama,tree,3,3_1000#33,84,207,291,0,LLAMA3/tree/MATH500/3_1000.jsonl,33
Llama,tree,3,3_1000#34,78,407,485,0,LLAMA3/tree/MATH500/3_1000.jsonl,34
Llama,tree,3,3_1000#35,66,696,762,1,LLAMA3/tree/MATH500/3_1000.jsonl,35
Llama,tree,3,3_1000#36,74,320,394,1,LLAMA3/tree/MATH500/3_1000.jsonl,36
Llama,tree,3,3_1000#37,62,852,914,0,LLAMA3/tree/MATH500/3_1000.jsonl,37
Llama,tree,3,3_1000#38,67,235,302,0,LLAMA3/tree/MATH500/3_1000.jsonl,38
Llama,tree,3,3_1000#39,74,230,304,0,LLAMA3/tree/MATH500/3_1000.jsonl,39
Llama,tree,3,3_1000#40,55,232,287,1,LLAMA3/tree/MATH500/3_1000.jsonl,40
Llama,tree,3,3_1000#41,130,154,284,1,LLAMA3/tree/MATH500/3_1000.jsonl,41
Llama,tree,3,3_1000#42,83,320,403,0,LLAMA3/tree/MATH500/3_1000.jsonl,42
Llama,tree,3,3_1000#43,73,301,374,0,LLAMA3/tree/MATH500/3_1000.jsonl,43
Llama,tree,3,3_1000#44,107,1001,1108,0,LLAMA3/tree/MATH500/3_1000.jsonl,44
Llama,tree,3,3_1000#45,97,405,502,0,LLAMA3/tree/MATH500/3_1000.jsonl,45
Llama,tree,3,3_1000#46,69,59,128,1,LLAMA3/tree/MATH500/3_1000.jsonl,46
Llama,tree,3,3_1000#47,77,880,957,0,LLAMA3/tree/MATH500/3_1000.jsonl,47
Llama,tree,3,3_1000#48,84,275,359,1,LLAMA3/tree/MATH500/3_1000.jsonl,48
Llama,tree,3,3_1000#49,52,464,516,1,LLAMA3/tree/MATH500/3_1000.jsonl,49
Llama,tree,3,3_1000#50,58,175,233,1,LLAMA3/tree/MATH500/3_1000.jsonl,50
Llama,tree,3,3_1000#51,129,535,664,0,LLAMA3/tree/MATH500/3_1000.jsonl,51
Llama,tree,3,3_1000#52,55,745,800,1,LLAMA3/tree/MATH500/3_1000.jsonl,52
Llama,tree,3,3_1000#53,63,174,237,1,LLAMA3/tree/MATH500/3_1000.jsonl,53
Llama,tree,3,3_1000#54,60,71,131,1,LLAMA3/tree/MATH500/3_1000.jsonl,54
Llama,tree,3,3_1000#55,45,76,121,0,LLAMA3/tree/MATH500/3_1000.jsonl,55
Llama,tree,3,3_1000#56,83,268,351,0,LLAMA3/tree/MATH500/3_1000.jsonl,56
Llama,tree,3,3_1000#57,57,118,175,0,LLAMA3/tree/MATH500/3_1000.jsonl,57
Llama,tree,3,3_1000#58,87,548,635,0,LLAMA3/tree/MATH500/3_1000.jsonl,58
Llama,tree,3,3_1000#59,47,205,252,0,LLAMA3/tree/MATH500/3_1000.jsonl,59
Llama,tree,3,3_1000#60,79,294,373,0,LLAMA3/tree/MATH500/3_1000.jsonl,60
Llama,tree,3,3_1000#61,83,1001,1084,0,LLAMA3/tree/MATH500/3_1000.jsonl,61
Llama,tree,3,3_1000#62,102,212,314,1,LLAMA3/tree/MATH500/3_1000.jsonl,62
Llama,tree,3,3_1000#63,139,675,814,0,LLAMA3/tree/MATH500/3_1000.jsonl,63
Llama,tree,3,3_1000#64,122,460,582,0,LLAMA3/tree/MATH500/3_1000.jsonl,64
Llama,tree,3,3_1000#65,99,635,734,0,LLAMA3/tree/MATH500/3_1000.jsonl,65
Llama,tree,3,3_1000#66,47,159,206,1,LLAMA3/tree/MATH500/3_1000.jsonl,66
Llama,tree,3,3_1000#67,71,346,417,0,LLAMA3/tree/MATH500/3_1000.jsonl,67
Llama,tree,3,3_1000#68,81,227,308,0,LLAMA3/tree/MATH500/3_1000.jsonl,68
Llama,tree,3,3_1000#69,94,1001,1095,0,LLAMA3/tree/MATH500/3_1000.jsonl,69
Llama,tree,3,3_1000#70,89,903,992,0,LLAMA3/tree/MATH500/3_1000.jsonl,70
Llama,tree,3,3_1000#71,53,303,356,1,LLAMA3/tree/MATH500/3_1000.jsonl,71
Llama,tree,3,3_1000#72,53,158,211,0,LLAMA3/tree/MATH500/3_1000.jsonl,72
Llama,tree,3,3_1000#73,67,226,293,1,LLAMA3/tree/MATH500/3_1000.jsonl,73
Llama,tree,3,3_1000#74,104,325,429,1,LLAMA3/tree/MATH500/3_1000.jsonl,74
Llama,tree,3,3_1000#75,60,422,482,0,LLAMA3/tree/MATH500/3_1000.jsonl,75
Llama,tree,3,3_1000#76,71,456,527,0,LLAMA3/tree/MATH500/3_1000.jsonl,76
Llama,tree,3,3_1000#77,73,113,186,1,LLAMA3/tree/MATH500/3_1000.jsonl,77
Llama,tree,3,3_1000#78,52,90,142,1,LLAMA3/tree/MATH500/3_1000.jsonl,78
Llama,tree,3,3_1000#79,102,1001,1103,0,LLAMA3/tree/MATH500/3_1000.jsonl,79
Llama,tree,3,3_1000#80,54,63,117,1,LLAMA3/tree/MATH500/3_1000.jsonl,80
Llama,tree,3,3_1000#81,75,1001,1076,0,LLAMA3/tree/MATH500/3_1000.jsonl,81
Llama,tree,3,3_1000#82,82,293,375,0,LLAMA3/tree/MATH500/3_1000.jsonl,82
Llama,tree,3,3_1000#83,120,609,729,1,LLAMA3/tree/MATH500/3_1000.jsonl,83
Llama,tree,3,3_1000#84,55,790,845,0,LLAMA3/tree/MATH500/3_1000.jsonl,84
Llama,tree,3,3_1000#85,86,484,570,1,LLAMA3/tree/MATH500/3_1000.jsonl,85
Llama,tree,3,3_1000#86,93,273,366,1,LLAMA3/tree/MATH500/3_1000.jsonl,86
Llama,tree,3,3_1000#87,71,101,172,0,LLAMA3/tree/MATH500/3_1000.jsonl,87
Llama,tree,3,3_1000#88,57,144,201,0,LLAMA3/tree/MATH500/3_1000.jsonl,88
Llama,tree,3,3_1000#89,120,506,626,1,LLAMA3/tree/MATH500/3_1000.jsonl,89
Llama,tree,3,3_1000#90,53,210,263,0,LLAMA3/tree/MATH500/3_1000.jsonl,90
Llama,tree,3,3_1000#91,74,88,162,0,LLAMA3/tree/MATH500/3_1000.jsonl,91
Llama,tree,3,3_1000#92,76,263,339,0,LLAMA3/tree/MATH500/3_1000.jsonl,92
Llama,tree,3,3_1000#93,73,285,358,1,LLAMA3/tree/MATH500/3_1000.jsonl,93
Llama,tree,3,3_1000#94,75,458,533,1,LLAMA3/tree/MATH500/3_1000.jsonl,94
Llama,tree,3,3_1000#95,375,646,1021,0,LLAMA3/tree/MATH500/3_1000.jsonl,95
Llama,tree,3,3_1000#96,113,439,552,0,LLAMA3/tree/MATH500/3_1000.jsonl,96
Llama,tree,3,3_1000#97,137,1001,1138,0,LLAMA3/tree/MATH500/3_1000.jsonl,97
Llama,tree,3,3_1000#98,76,212,288,0,LLAMA3/tree/MATH500/3_1000.jsonl,98
Llama,tree,3,3_1000#99,51,110,161,0,LLAMA3/tree/MATH500/3_1000.jsonl,99
Llama,tree,3,3_1000#100,130,616,746,0,LLAMA3/tree/MATH500/3_1000.jsonl,100
Llama,tree,9,9_1000#1,81,289,370,0,LLAMA3/tree/MATH500/9_1000.jsonl,1
Llama,tree,9,9_1000#2,144,1001,1145,0,LLAMA3/tree/MATH500/9_1000.jsonl,2
Llama,tree,9,9_1000#3,80,403,483,1,LLAMA3/tree/MATH500/9_1000.jsonl,3
Llama,tree,9,9_1000#4,45,138,183,0,LLAMA3/tree/MATH500/9_1000.jsonl,4
Llama,tree,9,9_1000#5,360,331,691,0,LLAMA3/tree/MATH500/9_1000.jsonl,5
Llama,tree,9,9_1000#6,73,127,200,0,LLAMA3/tree/MATH500/9_1000.jsonl,6
Llama,tree,9,9_1000#7,52,761,813,0,LLAMA3/tree/MATH500/9_1000.jsonl,7
Llama,tree,9,9_1000#8,99,1001,1100,0,LLAMA3/tree/MATH500/9_1000.jsonl,8
Llama,tree,9,9_1000#9,67,260,327,1,LLAMA3/tree/MATH500/9_1000.jsonl,9
Llama,tree,9,9_1000#10,174,688,862,0,LLAMA3/tree/MATH500/9_1000.jsonl,10
Llama,tree,9,9_1000#11,57,209,266,0,LLAMA3/tree/MATH500/9_1000.jsonl,11
Llama,tree,9,9_1000#12,92,1001,1093,0,LLAMA3/tree/MATH500/9_1000.jsonl,12
Llama,tree,9,9_1000#13,101,239,340,1,LLAMA3/tree/MATH500/9_1000.jsonl,13
Llama,tree,9,9_1000#14,204,176,380,1,LLAMA3/tree/MATH500/9_1000.jsonl,14
Llama,tree,9,9_1000#15,144,309,453,0,LLAMA3/tree/MATH500/9_1000.jsonl,15
Llama,tree,9,9_1000#16,211,972,1183,1,LLAMA3/tree/MATH500/9_1000.jsonl,16
Llama,tree,9,9_1000#17,54,356,410,1,LLAMA3/tree/MATH500/9_1000.jsonl,17
Llama,tree,9,9_1000#18,240,562,802,0,LLAMA3/tree/MATH500/9_1000.jsonl,18
Llama,tree,9,9_1000#19,179,1001,1180,0,LLAMA3/tree/MATH500/9_1000.jsonl,19
Llama,tree,9,9_1000#20,81,480,561,1,LLAMA3/tree/MATH500/9_1000.jsonl,20
Llama,tree,9,9_1000#21,46,114,160,0,LLAMA3/tree/MATH500/9_1000.jsonl,21
Llama,tree,9,9_1000#22,62,1001,1063,0,LLAMA3/tree/MATH500/9_1000.jsonl,22
Llama,tree,9,9_1000#23,158,550,708,1,LLAMA3/tree/MATH500/9_1000.jsonl,23
Llama,tree,9,9_1000#24,61,604,665,0,LLAMA3/tree/MATH500/9_1000.jsonl,24
Llama,tree,9,9_1000#25,130,425,555,1,LLAMA3/tree/MATH500/9_1000.jsonl,25
Llama,tree,9,9_1000#26,112,1001,1113,0,LLAMA3/tree/MATH500/9_1000.jsonl,26
Llama,tree,9,9_1000#27,85,379,464,0,LLAMA3/tree/MATH500/9_1000.jsonl,27
Llama,tree,9,9_1000#28,110,238,348,0,LLAMA3/tree/MATH500/9_1000.jsonl,28
Llama,tree,9,9_1000#29,67,187,254,1,LLAMA3/tree/MATH500/9_1000.jsonl,29
Llama,tree,9,9_1000#30,110,250,360,0,LLAMA3/tree/MATH500/9_1000.jsonl,30
Llama,tree,9,9_1000#31,57,390,447,0,LLAMA3/tree/MATH500/9_1000.jsonl,31
Llama,tree,9,9_1000#32,41,157,198,0,LLAMA3/tree/MATH500/9_1000.jsonl,32
Llama,tree,9,9_1000#33,84,211,295,1,LLAMA3/tree/MATH500/9_1000.jsonl,33
Llama,tree,9,9_1000#34,78,490,568,1,LLAMA3/tree/MATH500/9_1000.jsonl,34
Llama,tree,9,9_1000#35,66,652,718,0,LLAMA3/tree/MATH500/9_1000.jsonl,35
Llama,tree,9,9_1000#36,74,162,236,1,LLAMA3/tree/MATH500/9_1000.jsonl,36
Llama,tree,9,9_1000#37,62,726,788,0,LLAMA3/tree/MATH500/9_1000.jsonl,37
Llama,tree,9,9_1000#38,67,245,312,0,LLAMA3/tree/MATH500/9_1000.jsonl,38
Llama,tree,9,9_1000#39,74,176,250,0,LLAMA3/tree/MATH500/9_1000.jsonl,39
Llama,tree,9,9_1000#40,55,302,357,0,LLAMA3/tree/MATH500/9_1000.jsonl,40
Llama,tree,9,9_1000#41,130,190,320,1,LLAMA3/tree/MATH500/9_1000.jsonl,41
Llama,tree,9,9_1000#42,83,318,401,0,LLAMA3/tree/MATH500/9_1000.jsonl,42
Llama,tree,9,9_1000#43,73,302,375,0,LLAMA3/tree/MATH500/9_1000.jsonl,43
Llama,tree,9,9_1000#44,107,1001,1108,0,LLAMA3/tree/MATH500/9_1000.jsonl,44
Llama,tree,9,9_1000#45,97,408,505,1,LLAMA3/tree/MATH500/9_1000.jsonl,45
Llama,tree,9,9_1000#46,69,501,570,1,LLAMA3/tree/MATH500/9_1000.jsonl,46
Llama,tree,9,9_1000#47,77,474,551,0,LLAMA3/tree/MATH500/9_1000.jsonl,47
Llama,tree,9,9_1000#48,84,274,358,1,LLAMA3/tree/MATH500/9_1000.jsonl,48
Llama,tree,9,9_1000#49,52,350,402,1,LLAMA3/tree/MATH500/9_1000.jsonl,49
Llama,tree,9,9_1000#50,58,181,239,1,LLAMA3/tree/MATH500/9_1000.jsonl,50
Llama,tree,9,9_1000#51,129,488,617,0,LLAMA3/tree/MATH500/9_1000.jsonl,51
Llama,tree,9,9_1000#52,55,829,884,1,LLAMA3/tree/MATH500/9_1000.jsonl,52
Llama,tree,9,9_1000#53,63,127,190,1,LLAMA3/tree/MATH500/9_1000.jsonl,53
Llama,tree,9,9_1000#54,60,75,135,1,LLAMA3/tree/MATH500/9_1000.jsonl,54
Llama,tree,9,9_1000#55,45,76,121,0,LLAMA3/tree/MATH500/9_1000.jsonl,55
Llama,tree,9,9_1000#56,83,257,340,0,LLAMA3/tree/MATH500/9_1000.jsonl,56
Llama,tree,9,9_1000#57,57,126,183,1,LLAMA3/tree/MATH500/9_1000.jsonl,57
Llama,tree,9,9_1000#58,87,548,635,0,LLAMA3/tree/MATH500/9_1000.jsonl,58
Llama,tree,9,9_1000#59,47,148,195,0,LLAMA3/tree/MATH500/9_1000.jsonl,59
Llama,tree,9,9_1000#60,79,385,464,0,LLAMA3/tree/MATH500/9_1000.jsonl,60
Llama,tree,9,9_1000#61,83,1001,1084,0,LLAMA3/tree/MATH500/9_1000.jsonl,61
Llama,tree,9,9_1000#62,102,601,703,1,LLAMA3/tree/MATH500/9_1000.jsonl,62
Llama,tree,9,9_1000#63,139,1001,1140,0,LLAMA3/tree/MATH500/9_1000.jsonl,63
Llama,tree,9,9_1000#64,122,820,942,1,LLAMA3/tree/MATH500/9_1000.jsonl,64
Llama,tree,9,9_1000#65,99,1001,1100,0,LLAMA3/tree/MATH500/9_1000.jsonl,65
Llama,tree,9,9_1000#66,47,131,178,1,LLAMA3/tree/MATH500/9_1000.jsonl,66
Llama,tree,9,9_1000#67,71,160,231,1,LLAMA3/tree/MATH500/9_1000.jsonl,67
Llama,tree,9,9_1000#68,81,227,308,0,LLAMA3/tree/MATH500/9_1000.jsonl,68
Llama,tree,9,9_1000#69,94,1001,1095,0,LLAMA3/tree/MATH500/9_1000.jsonl,69
Llama,tree,9,9_1000#70,89,1001,1090,0,LLAMA3/tree/MATH500/9_1000.jsonl,70
Llama,tree,9,9_1000#71,53,303,356,1,LLAMA3/tree/MATH500/9_1000.jsonl,71
Llama,tree,9,9_1000#72,53,156,209,0,LLAMA3/tree/MATH500/9_1000.jsonl,72
Llama,tree,9,9_1000#73,67,226,293,1,LLAMA3/tree/MATH500/9_1000.jsonl,73
Llama,tree,9,9_1000#74,104,319,423,1,LLAMA3/tree/MATH500/9_1000.jsonl,74
Llama,tree,9,9_1000#75,60,204,264,0,LLAMA3/tree/MATH500/9_1000.jsonl,75
Llama,tree,9,9_1000#76,71,480,551,1,LLAMA3/tree/MATH500/9_1000.jsonl,76
Llama,tree,9,9_1000#77,73,171,244,1,LLAMA3/tree/MATH500/9_1000.jsonl,77
Llama,tree,9,9_1000#78,52,128,180,1,LLAMA3/tree/MATH500/9_1000.jsonl,78
Llama,tree,9,9_1000#79,102,975,1077,0,LLAMA3/tree/MATH500/9_1000.jsonl,79
Llama,tree,9,9_1000#80,54,65,119,1,LLAMA3/tree/MATH500/9_1000.jsonl,80
Llama,tree,9,9_1000#81,75,621,696,0,LLAMA3/tree/MATH500/9_1000.jsonl,81
Llama,tree,9,9_1000#82,82,186,268,0,LLAMA3/tree/MATH500/9_1000.jsonl,82
Llama,tree,9,9_1000#83,120,377,497,0,LLAMA3/tree/MATH500/9_1000.jsonl,83
Llama,tree,9,9_1000#84,55,911,966,0,LLAMA3/tree/MATH500/9_1000.jsonl,84
Llama,tree,9,9_1000#85,86,634,720,1,LLAMA3/tree/MATH500/9_1000.jsonl,85
Llama,tree,9,9_1000#86,93,255,348,1,LLAMA3/tree/MATH500/9_1000.jsonl,86
Llama,tree,9,9_1000#87,71,101,172,0,LLAMA3/tree/MATH500/9_1000.jsonl,87
Llama,tree,9,9_1000#88,57,291,348,1,LLAMA3/tree/MATH500/9_1000.jsonl,88
Llama,tree,9,9_1000#89,120,1001,1121,0,LLAMA3/tree/MATH500/9_1000.jsonl,89
Llama,tree,9,9_1000#90,53,378,431,0,LLAMA3/tree/MATH500/9_1000.jsonl,90
Llama,tree,9,9_1000#91,74,134,208,0,LLAMA3/tree/MATH500/9_1000.jsonl,91
Llama,tree,9,9_1000#92,76,429,505,0,LLAMA3/tree/MATH500/9_1000.jsonl,92
Llama,tree,9,9_1000#93,73,464,537,0,LLAMA3/tree/MATH500/9_1000.jsonl,93
Llama,tree,9,9_1000#94,75,455,530,1,LLAMA3/tree/MATH500/9_1000.jsonl,94
Llama,tree,9,9_1000#95,375,166,541,0,LLAMA3/tree/MATH500/9_1000.jsonl,95
Llama,tree,9,9_1000#96,113,1001,1114,0,LLAMA3/tree/MATH500/9_1000.jsonl,96
Llama,tree,9,9_1000#97,137,1001,1138,0,LLAMA3/tree/MATH500/9_1000.jsonl,97
Llama,tree,9,9_1000#98,76,208,284,0,LLAMA3/tree/MATH500/9_1000.jsonl,98
Llama,tree,9,9_1000#99,51,161,212,0,LLAMA3/tree/MATH500/9_1000.jsonl,99
Llama,tree,9,9_1000#100,130,1001,1131,0,LLAMA3/tree/MATH500/9_1000.jsonl,100
Llama,sampling,,sample#1,81,238,319,0,LLAMA3/sample/MATH500/sample.jsonl,1
Llama,sampling,,sample#2,144,612,756,0,LLAMA3/sample/MATH500/sample.jsonl,2
Llama,sampling,,sample#3,80,232,312,1,LLAMA3/sample/MATH500/sample.jsonl,3
Llama,sampling,,sample#4,45,191,236,0,LLAMA3/sample/MATH500/sample.jsonl,4
Llama,sampling,,sample#5,360,79,439,0,LLAMA3/sample/MATH500/sample.jsonl,5
Llama,sampling,,sample#6,73,137,210,0,LLAMA3/sample/MATH500/sample.jsonl,6
Llama,sampling,,sample#7,52,411,463,1,LLAMA3/sample/MATH500/sample.jsonl,7
Llama,sampling,,sample#8,99,832,931,0,LLAMA3/sample/MATH500/sample.jsonl,8
Llama,sampling,,sample#9,67,191,258,0,LLAMA3/sample/MATH500/sample.jsonl,9
Llama,sampling,,sample#10,174,320,494,0,LLAMA3/sample/MATH500/sample.jsonl,10
Llama,sampling,,sample#11,57,1000,1057,0,LLAMA3/sample/MATH500/sample.jsonl,11
Llama,sampling,,sample#12,92,552,644,0,LLAMA3/sample/MATH500/sample.jsonl,12
Llama,sampling,,sample#13,101,135,236,0,LLAMA3/sample/MATH500/sample.jsonl,13
Llama,sampling,,sample#14,204,189,393,1,LLAMA3/sample/MATH500/sample.jsonl,14
Llama,sampling,,sample#15,144,115,259,0,LLAMA3/sample/MATH500/sample.jsonl,15
Llama,sampling,,sample#16,211,919,1130,0,LLAMA3/sample/MATH500/sample.jsonl,16
Llama,sampling,,sample#17,54,98,152,0,LLAMA3/sample/MATH500/sample.jsonl,17
Llama,sampling,,sample#18,240,319,559,0,LLAMA3/sample/MATH500/sample.jsonl,18
Llama,sampling,,sample#19,179,280,459,0,LLAMA3/sample/MATH500/sample.jsonl,19
Llama,sampling,,sample#20,81,634,715,0,LLAMA3/sample/MATH500/sample.jsonl,20
Llama,sampling,,sample#21,46,134,180,1,LLAMA3/sample/MATH500/sample.jsonl,21
Llama,sampling,,sample#22,62,852,914,0,LLAMA3/sample/MATH500/sample.jsonl,22
Llama,sampling,,sample#23,158,1000,1158,0,LLAMA3/sample/MATH500/sample.jsonl,23
Llama,sampling,,sample#24,61,586,647,0,LLAMA3/sample/MATH500/sample.jsonl,24
Llama,sampling,,sample#25,130,245,375,0,LLAMA3/sample/MATH500/sample.jsonl,25
Llama,sampling,,sample#26,112,557,669,0,LLAMA3/sample/MATH500/sample.jsonl,26
Llama,sampling,,sample#27,85,281,366,0,LLAMA3/sample/MATH500/sample.jsonl,27
Llama,sampling,,sample#28,110,203,313,0,LLAMA3/sample/MATH500/sample.jsonl,28
Llama,sampling,,sample#29,67,149,216,0,LLAMA3/sample/MATH500/sample.jsonl,29
Llama,sampling,,sample#30,110,327,437,0,LLAMA3/sample/MATH500/sample.jsonl,30
Llama,sampling,,sample#31,57,240,297,1,LLAMA3/sample/MATH500/sample.jsonl,31
Llama,sampling,,sample#32,41,208,249,0,LLAMA3/sample/MATH500/sample.jsonl,32
Llama,sampling,,sample#33,84,237,321,0,LLAMA3/sample/MATH500/sample.jsonl,33
Llama,sampling,,sample#34,78,549,627,0,LLAMA3/sample/MATH500/sample.jsonl,34
Llama,sampling,,sample#35,66,470,536,0,LLAMA3/sample/MATH500/sample.jsonl,35
Llama,sampling,,sample#36,74,329,403,0,LLAMA3/sample/MATH500/sample.jsonl,36
Llama,sampling,,sample#37,62,963,1025,0,LLAMA3/sample/MATH500/sample.jsonl,37
Llama,sampling,,sample#38,67,258,325,0,LLAMA3/sample/MATH500/sample.jsonl,38
Llama,sampling,,sample#39,74,203,277,1,LLAMA3/sample/MATH500/sample.jsonl,39
Llama,sampling,,sample#40,55,221,276,0,LLAMA3/sample/MATH500/sample.jsonl,40
Llama,sampling,,sample#41,130,95,225,0,LLAMA3/sample/MATH500/sample.jsonl,41
Llama,sampling,,sample#42,83,452,535,0,LLAMA3/sample/MATH500/sample.jsonl,42
Llama,sampling,,sample#43,73,123,196,0,LLAMA3/sample/MATH500/sample.jsonl,43
Llama,sampling,,sample#44,107,701,808,0,LLAMA3/sample/MATH500/sample.jsonl,44
Llama,sampling,,sample#45,97,372,469,1,LLAMA3/sample/MATH500/sample.jsonl,45
Llama,sampling,,sample#46,69,77,146,1,LLAMA3/sample/MATH500/sample.jsonl,46
Llama,sampling,,sample#47,77,441,518,0,LLAMA3/sample/MATH500/sample.jsonl,47
Llama,sampling,,sample#48,84,383,467,1,LLAMA3/sample/MATH500/sample.jsonl,48
Llama,sampling,,sample#49,52,150,202,0,LLAMA3/sample/MATH500/sample.jsonl,49
Llama,sampling,,sample#50,58,113,171,0,LLAMA3/sample/MATH500/sample.jsonl,50
Llama,sampling,,sample#51,129,379,508,0,LLAMA3/sample/MATH500/sample.jsonl,51
Llama,sampling,,sample#52,55,245,300,0,LLAMA3/sample/MATH500/sample.jsonl,52
Llama,sampling,,sample#53,63,219,282,0,LLAMA3/sample/MATH500/sample.jsonl,53
Llama,sampling,,sample#54,60,101,161,0,LLAMA3/sample/MATH500/sample.jsonl,54
Llama,sampling,,sample#55,45,79,124,1,LLAMA3/sample/MATH500/sample.jsonl,55
Llama,sampling,,sample#56,83,109,192,1,LLAMA3/sample/MATH500/sample.jsonl,56
Llama,sampling,,sample#57,57,201,258,1,LLAMA3/sample/MATH500/sample.jsonl,57
Llama,sampling,,sample#58,87,650,737,1,LLAMA3/sample/MATH500/sample.jsonl,58
Llama,sampling,,sample#59,47,681,728,0,LLAMA3/sample/MATH500/sample.jsonl,59
Llama,sampling,,sample#60,79,217,296,0,LLAMA3/sample/MATH500/sample.jsonl,60
Llama,sampling,,sample#61,83,1000,1083,0,LLAMA3/sample/MATH500/sample.jsonl,61
Llama,sampling,,sample#62,102,391,493,0,LLAMA3/sample/MATH500/sample.jsonl,62
Llama,sampling,,sample#63,139,795,934,0,LLAMA3/sample/MATH500/sample.jsonl,63
Llama,sampling,,sample#64,122,472,594,0,LLAMA3/sample/MATH500/sample.jsonl,64
Llama,sampling,,sample#65,99,1000,1099,0,LLAMA3/sample/MATH500/sample.jsonl,65
Llama,sampling,,sample#66,47,179,226,1,LLAMA3/sample/MATH500/sample.jsonl,66
Llama,sampling,,sample#67,71,264,335,1,LLAMA3/sample/MATH500/sample.jsonl,67
Llama,sampling,,sample#68,81,296,377,0,LLAMA3/sample/MATH500/sample.jsonl,68
Llama,sampling,,sample#69,94,1000,1094,0,LLAMA3/sample/MATH500/sample.jsonl,69
Llama,sampling,,sample#70,89,784,873,0,LLAMA3/sample/MATH500/sample.jsonl,70
Llama,sampling,,sample#71,53,118,171,1,LLAMA3/sample/MATH500/sample.jsonl,71
Llama,sampling,,sample#72,53,375,428,0,LLAMA3/sample/MATH500/sample.jsonl,72
Llama,sampling,,sample#73,67,391,458,0,LLAMA3/sample/MATH500/sample.jsonl,73
Llama,sampling,,sample#74,104,170,274,0,LLAMA3/sample/MATH500/sample.jsonl,74
Llama,sampling,,sample#75,60,438,498,0,LLAMA3/sample/MATH500/sample.jsonl,75
Llama,sampling,,sample#76,71,311,382,0,LLAMA3/sample/MATH500/sample.jsonl,76
Llama,sampling,,sample#77,73,92,165,1,LLAMA3/sample/MATH500/sample.jsonl,77
Llama,sampling,,sample#78,52,264,316,1,LLAMA3/sample/MATH500/sample.jsonl,78
Llama,sampling,,sample#79,102,633,735,0,LLAMA3/sample/MATH500/sample.jsonl,79
Llama,sampling,,sample#80,54,91,145,1,LLAMA3/sample/MATH500/sample.jsonl,80
Llama,sampling,,sample#81,75,302,377,0,LLAMA3/sample/MATH500/sample.jsonl,81
Llama,sampling,,sample#82,82,249,331,0,LLAMA3/sample/MATH500/sample.jsonl,82
Llama,sampling,,sample#83,120,1000,1120,0,LLAMA3/sample/MATH500/sample.jsonl,83
Llama,sampling,,sample#84,55,258,313,0,LLAMA3/sample/MATH500/sample.jsonl,84
Llama,sampling,,sample#85,86,537,623,0,LLAMA3/sample/MATH500/sample.jsonl,85
Llama,sampling,,sample#86,93,329,422,0,LLAMA3/sample/MATH500/sample.jsonl,86
Llama,sampling,,sample#87,71,123,194,0,LLAMA3/sample/MATH500/sample.jsonl,87
Llama,sampling,,sample#88,57,271,328,1,LLAMA3/sample/MATH500/sample.jsonl,88
Llama,sampling,,sample#89,120,1000,1120,1,LLAMA3/sample/MATH500/sample.jsonl,89
Llama,sampling,,sample#90,53,228,281,0,LLAMA3/sample/MATH500/sample.jsonl,90
Llama,sampling,,sample#91,74,120,194,0,LLAMA3/sample/MATH500/sample.jsonl,91
Llama,sampling,,sample#92,76,226,302,0,LLAMA3/sample/MATH500/sample.jsonl,92
Llama,sampling,,sample#93,73,154,227,0,LLAMA3/sample/MATH500/sample.jsonl,93
Llama,sampling,,sample#94,75,177,252,1,LLAMA3/sample/MATH500/sample.jsonl,94
Llama,sampling,,sample#95,375,877,1252,0,LLAMA3/sample/MATH500/sample.jsonl,95
Llama,sampling,,sample#96,113,419,532,0,LLAMA3/sample/MATH500/sample.jsonl,96
Llama,sampling,,sample#97,137,585,722,0,LLAMA3/sample/MATH500/sample.jsonl,97
Llama,sampling,,sample#98,76,161,237,0,LLAMA3/sample/MATH500/sample.jsonl,98
Llama,sampling,,sample#99,51,316,367,1,LLAMA3/sample/MATH500/sample.jsonl,99
Llama,sampling,,sample#100,130,688,818,0,LLAMA3/sample/MATH500/sample.jsonl,100
Mistral,origin,1,1_1000#1,76,201,277,1,MISTRAL/origin/MATH500/1_1000.jsonl,1
Mistral,origin,1,1_1000#2,124,621,745,1,MISTRAL/origin/MATH500/1_1000.jsonl,2
Mistral,origin,1,1_1000#3,74,358,432,1,MISTRAL/origin/MATH500/1_1000.jsonl,3
Mistral,origin,1,1_1000#4,42,327,369,1,MISTRAL/origin/MATH500/1_1000.jsonl,4
Mistral,origin,1,1_1000#5,378,405,783,1,MISTRAL/origin/MATH500/1_1000.jsonl,5
Mistral,origin,1,1_1000#6,69,233,302,1,MISTRAL/origin/MATH500/1_1000.jsonl,6
Mistral,origin,1,1_1000#7,47,341,388,1,MISTRAL/origin/MATH500/1_1000.jsonl,7
Mistral,origin,1,1_1000#8,92,1000,1092,0,MISTRAL/origin/MATH500/1_1000.jsonl,8
Mistral,origin,1,1_1000#9,62,286,348,1,MISTRAL/origin/MATH500/1_1000.jsonl,9
Mistral,origin,1,1_1000#10,170,1000,1170,0,MISTRAL/origin/MATH500/1_1000.jsonl,10
Mistral,origin,1,1_1000#11,53,340,393,1,MISTRAL/origin/MATH500/1_1000.jsonl,11
Mistral,origin,1,1_1000#12,86,350,436,0,MISTRAL/origin/MATH500/1_1000.jsonl,12
Mistral,origin,1,1_1000#13,99,401,500,1,MISTRAL/origin/MATH500/1_1000.jsonl,13
Mistral,origin,1,1_1000#14,206,190,396,1,MISTRAL/origin/MATH500/1_1000.jsonl,14
Mistral,origin,1,1_1000#15,147,152,299,0,MISTRAL/origin/MATH500/1_1000.jsonl,15
Mistral,origin,1,1_1000#16,211,516,727,0,MISTRAL/origin/MATH500/1_1000.jsonl,16
Mistral,origin,1,1_1000#17,51,256,307,1,MISTRAL/origin/MATH500/1_1000.jsonl,17
Mistral,origin,1,1_1000#18,252,495,747,0,MISTRAL/origin/MATH500/1_1000.jsonl,18
Mistral,origin,1,1_1000#19,180,685,865,1,MISTRAL/origin/MATH500/1_1000.jsonl,19
Mistral,origin,1,1_1000#20,74,956,1030,0,MISTRAL/origin/MATH500/1_1000.jsonl,20
Mistral,origin,1,1_1000#21,41,133,174,1,MISTRAL/origin/MATH500/1_1000.jsonl,21
Mistral,origin,1,1_1000#22,56,940,996,1,MISTRAL/origin/MATH500/1_1000.jsonl,22
Mistral,origin,1,1_1000#23,153,511,664,0,MISTRAL/origin/MATH500/1_1000.jsonl,23
Mistral,origin,1,1_1000#24,56,366,422,0,MISTRAL/origin/MATH500/1_1000.jsonl,24
Mistral,origin,1,1_1000#25,129,869,998,1,MISTRAL/origin/MATH500/1_1000.jsonl,25
Mistral,origin,1,1_1000#26,107,612,719,0,MISTRAL/origin/MATH500/1_1000.jsonl,26
Mistral,origin,1,1_1000#27,80,856,936,0,MISTRAL/origin/MATH500/1_1000.jsonl,27
Mistral,origin,1,1_1000#28,113,341,454,1,MISTRAL/origin/MATH500/1_1000.jsonl,28
Mistral,origin,1,1_1000#29,64,268,332,1,MISTRAL/origin/MATH500/1_1000.jsonl,29
Mistral,origin,1,1_1000#30,104,446,550,1,MISTRAL/origin/MATH500/1_1000.jsonl,30
Mistral,origin,1,1_1000#31,51,228,279,1,MISTRAL/origin/MATH500/1_1000.jsonl,31
Mistral,origin,1,1_1000#32,38,727,765,0,MISTRAL/origin/MATH500/1_1000.jsonl,32
Mistral,origin,1,1_1000#33,79,350,429,1,MISTRAL/origin/MATH500/1_1000.jsonl,33
Mistral,origin,1,1_1000#34,75,526,601,0,MISTRAL/origin/MATH500/1_1000.jsonl,34
Mistral,origin,1,1_1000#35,58,694,752,0,MISTRAL/origin/MATH500/1_1000.jsonl,35
Mistral,origin,1,1_1000#36,67,312,379,1,MISTRAL/origin/MATH500/1_1000.jsonl,36
Mistral,origin,1,1_1000#37,57,492,549,1,MISTRAL/origin/MATH500/1_1000.jsonl,37
Mistral,origin,1,1_1000#38,60,340,400,0,MISTRAL/origin/MATH500/1_1000.jsonl,38
Mistral,origin,1,1_1000#39,69,216,285,1,MISTRAL/origin/MATH500/1_1000.jsonl,39
Mistral,origin,1,1_1000#40,55,519,574,1,MISTRAL/origin/MATH500/1_1000.jsonl,40
Mistral,origin,1,1_1000#41,140,234,374,1,MISTRAL/origin/MATH500/1_1000.jsonl,41
Mistral,origin,1,1_1000#42,78,521,599,0,MISTRAL/origin/MATH500/1_1000.jsonl,42
Mistral,origin,1,1_1000#43,66,250,316,1,MISTRAL/origin/MATH500/1_1000.jsonl,43
Mistral,origin,1,1_1000#44,109,706,815,0,MISTRAL/origin/MATH500/1_1000.jsonl,44
Mistral,origin,1,1_1000#45,92,399,491,1,MISTRAL/origin/MATH500/1_1000.jsonl,45
Mistral,origin,1,1_1000#46,64,436,500,1,MISTRAL/origin/MATH500/1_1000.jsonl,46
Mistral,origin,1,1_1000#47,70,426,496,1,MISTRAL/origin/MATH500/1_1000.jsonl,47
Mistral,origin,1,1_1000#48,78,295,373,1,MISTRAL/origin/MATH500/1_1000.jsonl,48
Mistral,origin,1,1_1000#49,47,241,288,1,MISTRAL/origin/MATH500/1_1000.jsonl,49
Mistral,origin,1,1_1000#50,54,187,241,1,MISTRAL/origin/MATH500/1_1000.jsonl,50
Mistral,origin,1,1_1000#51,130,1000,1130,0,MISTRAL/origin/MATH500/1_1000.jsonl,51
Mistral,origin,1,1_1000#52,49,677,726,1,MISTRAL/origin/MATH500/1_1000.jsonl,52
Mistral,origin,1,1_1000#53,57,210,267,1,MISTRAL/origin/MATH500/1_1000.jsonl,53
Mistral,origin,1,1_1000#54,54,159,213,1,MISTRAL/origin/MATH500/1_1000.jsonl,54
Mistral,origin,1,1_1000#55,41,233,274,1,MISTRAL/origin/MATH500/1_1000.jsonl,55
Mistral,origin,1,1_1000#56,79,349,428,1,MISTRAL/origin/MATH500/1_1000.jsonl,56
Mistral,origin,1,1_1000#57,54,216,270,1,MISTRAL/origin/MATH500/1_1000.jsonl,57
Mistral,origin,1,1_1000#58,82,422,504,1,MISTRAL/origin/MATH500/1_1000.jsonl,58
Mistral,origin,1,1_1000#59,44,249,293,0,MISTRAL/origin/MATH500/1_1000.jsonl,59
Mistral,origin,1,1_1000#60,79,420,499,1,MISTRAL/origin/MATH500/1_1000.jsonl,60
Mistral,origin,1,1_1000#61,79,519,598,0,MISTRAL/origin/MATH500/1_1000.jsonl,61
Mistral,origin,1,1_1000#62,96,133,229,1,MISTRAL/origin/MATH500/1_1000.jsonl,62
Mistral,origin,1,1_1000#63,117,932,1049,0,MISTRAL/origin/MATH500/1_1000.jsonl,63
Mistral,origin,1,1_1000#64,115,744,859,0,MISTRAL/origin/MATH500/1_1000.jsonl,64
Mistral,origin,1,1_1000#65,91,1000,1091,0,MISTRAL/origin/MATH500/1_1000.jsonl,65
Mistral,origin,1,1_1000#66,47,129,176,1,MISTRAL/origin/MATH500/1_1000.jsonl,66
Mistral,origin,1,1_1000#67,60,300,360,0,MISTRAL/origin/MATH500/1_1000.jsonl,67
Mistral,origin,1,1_1000#68,76,192,268,0,MISTRAL/origin/MATH500/1_1000.jsonl,68
Mistral,origin,1,1_1000#69,92,696,788,0,MISTRAL/origin/MATH500/1_1000.jsonl,69
Mistral,origin,1,1_1000#70,81,414,495,0,MISTRAL/origin/MATH500/1_1000.jsonl,70
Mistral,origin,1,1_1000#71,49,288,337,1,MISTRAL/origin/MATH500/1_1000.jsonl,71
Mistral,origin,1,1_1000#72,55,280,335,0,MISTRAL/origin/MATH500/1_1000.jsonl,72
Mistral,origin,1,1_1000#73,61,252,313,1,MISTRAL/origin/MATH500/1_1000.jsonl,73
Mistral,origin,1,1_1000#74,92,271,363,1,MISTRAL/origin/MATH500/1_1000.jsonl,74
Mistral,origin,1,1_1000#75,51,280,331,1,MISTRAL/origin/MATH500/1_1000.jsonl,75
Mistral,origin,1,1_1000#76,66,278,344,1,MISTRAL/origin/MATH500/1_1000.jsonl,76
Mistral,origin,1,1_1000#77,67,192,259,1,MISTRAL/origin/MATH500/1_1000.jsonl,77
Mistral,origin,1,1_1000#78,46,213,259,1,MISTRAL/origin/MATH500/1_1000.jsonl,78
Mistral,origin,1,1_1000#79,95,837,932,0,MISTRAL/origin/MATH500/1_1000.jsonl,79
Mistral,origin,1,1_1000#80,48,147,195,1,MISTRAL/origin/MATH500/1_1000.jsonl,80
Mistral,origin,1,1_1000#81,73,798,871,0,MISTRAL/origin/MATH500/1_1000.jsonl,81
Mistral,origin,1,1_1000#82,77,313,390,1,MISTRAL/origin/MATH500/1_1000.jsonl,82
Mistral,origin,1,1_1000#83,113,326,439,0,MISTRAL/origin/MATH500/1_1000.jsonl,83
Mistral,origin,1,1_1000#84,50,426,476,1,MISTRAL/origin/MATH500/1_1000.jsonl,84
Mistral,origin,1,1_1000#85,84,255,339,0,MISTRAL/origin/MATH500/1_1000.jsonl,85
Mistral,origin,1,1_1000#86,88,356,444,1,MISTRAL/origin/MATH500/1_1000.jsonl,86
Mistral,origin,1,1_1000#87,67,273,340,1,MISTRAL/origin/MATH500/1_1000.jsonl,87
Mistral,origin,1,1_1000#88,50,241,291,1,MISTRAL/origin/MATH500/1_1000.jsonl,88
Mistral,origin,1,1_1000#89,105,1000,1105,0,MISTRAL/origin/MATH500/1_1000.jsonl,89
Mistral,origin,1,1_1000#90,53,759,812,1,MISTRAL/origin/MATH500/1_1000.jsonl,90
Mistral,origin,1,1_1000#91,70,200,270,1,MISTRAL/origin/MATH500/1_1000.jsonl,91
Mistral,origin,1,1_1000#92,69,237,306,1,MISTRAL/origin/MATH500/1_1000.jsonl,92
Mistral,origin,1,1_1000#93,68,609,677,0,MISTRAL/origin/MATH500/1_1000.jsonl,93
Mistral,origin,1,1_1000#94,71,357,428,1,MISTRAL/origin/MATH500/1_1000.jsonl,94
Mistral,origin,1,1_1000#95,390,407,797,0,MISTRAL/origin/MATH500/1_1000.jsonl,95
Mistral,origin,1,1_1000#96,92,562,654,1,MISTRAL/origin/MATH500/1_1000.jsonl,96
Mistral,origin,1,1_1000#97,131,868,999,0,MISTRAL/origin/MATH500/1_1000.jsonl,97
Mistral,origin,1,1_1000#98,74,190,264,1,MISTRAL/origin/MATH500/1_1000.jsonl,98
Mistral,origin,1,1_1000#99,46,125,171,0,MISTRAL/origin/MATH500/1_1000.jsonl,99
Mistral,origin,1,1_1000#100,104,575,679,0,MISTRAL/origin/MATH500/1_1000.jsonl,100
Mistral,origin,3,3_1000#1,76,214,290,1,MISTRAL/origin/MATH500/3_1000.jsonl,1
Mistral,origin,3,3_1000#2,124,823,947,1,MISTRAL/origin/MATH500/3_1000.jsonl,2
Mistral,origin,3,3_1000#3,74,381,455,1,MISTRAL/origin/MATH500/3_1000.jsonl,3
Mistral,origin,3,3_1000#4,42,303,345,1,MISTRAL/origin/MATH500/3_1000.jsonl,4
Mistral,origin,3,3_1000#5,378,405,783,1,MISTRAL/origin/MATH500/3_1000.jsonl,5
Mistral,origin,3,3_1000#6,69,233,302,1,MISTRAL/origin/MATH500/3_1000.jsonl,6
Mistral,origin,3,3_1000#7,47,341,388,1,MISTRAL/origin/MATH500/3_1000.jsonl,7
Mistral,origin,3,3_1000#8,92,704,796,0,MISTRAL/origin/MATH500/3_1000.jsonl,8
Mistral,origin,3,3_1000#9,62,389,451,1,MISTRAL/origin/MATH500/3_1000.jsonl,9
Mistral,origin,3,3_1000#10,170,1000,1170,0,MISTRAL/origin/MATH500/3_1000.jsonl,10
Mistral,origin,3,3_1000#11,53,325,378,1,MISTRAL/origin/MATH500/3_1000.jsonl,11
Mistral,origin,3,3_1000#12,86,389,475,0,MISTRAL/origin/MATH500/3_1000.jsonl,12
Mistral,origin,3,3_1000#13,99,401,500,1,MISTRAL/origin/MATH500/3_1000.jsonl,13
Mistral,origin,3,3_1000#14,206,190,396,1,MISTRAL/origin/MATH500/3_1000.jsonl,14
Mistral,origin,3,3_1000#15,147,152,299,0,MISTRAL/origin/MATH500/3_1000.jsonl,15
Mistral,origin,3,3_1000#16,211,579,790,0,MISTRAL/origin/MATH500/3_1000.jsonl,16
Mistral,origin,3,3_1000#17,51,250,301,1,MISTRAL/origin/MATH500/3_1000.jsonl,17
Mistral,origin,3,3_1000#18,252,508,760,0,MISTRAL/origin/MATH500/3_1000.jsonl,18
Mistral,origin,3,3_1000#19,180,1000,1180,0,MISTRAL/origin/MATH500/3_1000.jsonl,19
Mistral,origin,3,3_1000#20,74,850,924,0,MISTRAL/origin/MATH500/3_1000.jsonl,20
Mistral,origin,3,3_1000#21,41,172,213,1,MISTRAL/origin/MATH500/3_1000.jsonl,21
Mistral,origin,3,3_1000#22,56,938,994,1,MISTRAL/origin/MATH500/3_1000.jsonl,22
Mistral,origin,3,3_1000#23,153,377,530,0,MISTRAL/origin/MATH500/3_1000.jsonl,23
Mistral,origin,3,3_1000#24,56,373,429,0,MISTRAL/origin/MATH500/3_1000.jsonl,24
Mistral,origin,3,3_1000#25,129,868,997,1,MISTRAL/origin/MATH500/3_1000.jsonl,25
Mistral,origin,3,3_1000#26,107,632,739,0,MISTRAL/origin/MATH500/3_1000.jsonl,26
Mistral,origin,3,3_1000#27,80,909,989,0,MISTRAL/origin/MATH500/3_1000.jsonl,27
Mistral,origin,3,3_1000#28,113,350,463,1,MISTRAL/origin/MATH500/3_1000.jsonl,28
Mistral,origin,3,3_1000#29,64,114,178,1,MISTRAL/origin/MATH500/3_1000.jsonl,29
Mistral,origin,3,3_1000#30,104,395,499,1,MISTRAL/origin/MATH500/3_1000.jsonl,30
Mistral,origin,3,3_1000#31,51,228,279,1,MISTRAL/origin/MATH500/3_1000.jsonl,31
Mistral,origin,3,3_1000#32,38,460,498,0,MISTRAL/origin/MATH500/3_1000.jsonl,32
Mistral,origin,3,3_1000#33,79,398,477,1,MISTRAL/origin/MATH500/3_1000.jsonl,33
Mistral,origin,3,3_1000#34,75,594,669,0,MISTRAL/origin/MATH500/3_1000.jsonl,34
Mistral,origin,3,3_1000#35,58,667,725,1,MISTRAL/origin/MATH500/3_1000.jsonl,35
Mistral,origin,3,3_1000#36,67,337,404,1,MISTRAL/origin/MATH500/3_1000.jsonl,36
Mistral,origin,3,3_1000#37,57,1000,1057,0,MISTRAL/origin/MATH500/3_1000.jsonl,37
Mistral,origin,3,3_1000#38,60,336,396,0,MISTRAL/origin/MATH500/3_1000.jsonl,38
Mistral,origin,3,3_1000#39,69,152,221,1,MISTRAL/origin/MATH500/3_1000.jsonl,39
Mistral,origin,3,3_1000#40,55,285,340,1,MISTRAL/origin/MATH500/3_1000.jsonl,40
Mistral,origin,3,3_1000#41,140,250,390,0,MISTRAL/origin/MATH500/3_1000.jsonl,41
Mistral,origin,3,3_1000#42,78,443,521,0,MISTRAL/origin/MATH500/3_1000.jsonl,42
Mistral,origin,3,3_1000#43,66,165,231,1,MISTRAL/origin/MATH500/3_1000.jsonl,43
Mistral,origin,3,3_1000#44,109,1000,1109,0,MISTRAL/origin/MATH500/3_1000.jsonl,44
Mistral,origin,3,3_1000#45,92,421,513,1,MISTRAL/origin/MATH500/3_1000.jsonl,45
Mistral,origin,3,3_1000#46,64,267,331,1,MISTRAL/origin/MATH500/3_1000.jsonl,46
Mistral,origin,3,3_1000#47,70,539,609,1,MISTRAL/origin/MATH500/3_1000.jsonl,47
Mistral,origin,3,3_1000#48,78,369,447,1,MISTRAL/origin/MATH500/3_1000.jsonl,48
Mistral,origin,3,3_1000#49,47,230,277,1,MISTRAL/origin/MATH500/3_1000.jsonl,49
Mistral,origin,3,3_1000#50,54,187,241,1,MISTRAL/origin/MATH500/3_1000.jsonl,50
Mistral,origin,3,3_1000#51,130,753,883,1,MISTRAL/origin/MATH500/3_1000.jsonl,51
Mistral,origin,3,3_1000#52,49,760,809,1,MISTRAL/origin/MATH500/3_1000.jsonl,52
Mistral,origin,3,3_1000#53,57,187,244,1,MISTRAL/origin/MATH500/3_1000.jsonl,53
Mistral,origin,3,3_1000#54,54,183,237,1,MISTRAL/origin/MATH500/3_1000.jsonl,54
Mistral,origin,3,3_1000#55,41,233,274,1,MISTRAL/origin/MATH500/3_1000.jsonl,55
Mistral,origin,3,3_1000#56,79,295,374,1,MISTRAL/origin/MATH500/3_1000.jsonl,56
Mistral,origin,3,3_1000#57,54,239,293,1,MISTRAL/origin/MATH500/3_1000.jsonl,57
Mistral,origin,3,3_1000#58,82,426,508,1,MISTRAL/origin/MATH500/3_1000.jsonl,58
Mistral,origin,3,3_1000#59,44,315,359,0,MISTRAL/origin/MATH500/3_1000.jsonl,59
Mistral,origin,3,3_1000#60,79,317,396,1,MISTRAL/origin/MATH500/3_1000.jsonl,60
Mistral,origin,3,3_1000#61,79,1000,1079,0,MISTRAL/origin/MATH500/3_1000.jsonl,61
Mistral,origin,3,3_1000#62,96,133,229,1,MISTRAL/origin/MATH500/3_1000.jsonl,62
Mistral,origin,3,3_1000#63,117,938,1055,1,MISTRAL/origin/MATH500/3_1000.jsonl,63
Mistral,origin,3,3_1000#64,115,468,583,0,MISTRAL/origin/MATH500/3_1000.jsonl,64
Mistral,origin,3,3_1000#65,91,856,947,0,MISTRAL/origin/MATH500/3_1000.jsonl,65
Mistral,origin,3,3_1000#66,47,159,206,1,MISTRAL/origin/MATH500/3_1000.jsonl,66
Mistral,origin,3,3_1000#67,60,300,360,0,MISTRAL/origin/MATH500/3_1000.jsonl,67
Mistral,origin,3,3_1000#68,76,195,271,0,MISTRAL/origin/MATH500/3_1000.jsonl,68
Mistral,origin,3,3_1000#69,92,833,925,1,MISTRAL/origin/MATH500/3_1000.jsonl,69
Mistral,origin,3,3_1000#70,81,342,423,1,MISTRAL/origin/MATH500/3_1000.jsonl,70
Mistral,origin,3,3_1000#71,49,288,337,1,MISTRAL/origin/MATH500/3_1000.jsonl,71
Mistral,origin,3,3_1000#72,55,386,441,0,MISTRAL/origin/MATH500/3_1000.jsonl,72
Mistral,origin,3,3_1000#73,61,281,342,1,MISTRAL/origin/MATH500/3_1000.jsonl,73
Mistral,origin,3,3_1000#74,92,261,353,1,MISTRAL/origin/MATH500/3_1000.jsonl,74
Mistral,origin,3,3_1000#75,51,315,366,1,MISTRAL/origin/MATH500/3_1000.jsonl,75
Mistral,origin,3,3_1000#76,66,269,335,1,MISTRAL/origin/MATH500/3_1000.jsonl,76
Mistral,origin,3,3_1000#77,67,248,315,0,MISTRAL/origin/MATH500/3_1000.jsonl,77
Mistral,origin,3,3_1000#78,46,199,245,1,MISTRAL/origin/MATH500/3_1000.jsonl,78
Mistral,origin,3,3_1000#79,95,975,1070,0,MISTRAL/origin/MATH500/3_1000.jsonl,79
Mistral,origin,3,3_1000#80,48,164,212,1,MISTRAL/origin/MATH500/3_1000.jsonl,80
Mistral,origin,3,3_1000#81,73,761,834,0,MISTRAL/origin/MATH500/3_1000.jsonl,81
Mistral,origin,3,3_1000#82,77,491,568,1,MISTRAL/origin/MATH500/3_1000.jsonl,82
Mistral,origin,3,3_1000#83,113,341,454,0,MISTRAL/origin/MATH500/3_1000.jsonl,83
Mistral,origin,3,3_1000#84,50,652,702,0,MISTRAL/origin/MATH500/3_1000.jsonl,84
Mistral,origin,3,3_1000#85,84,316,400,1,MISTRAL/origin/MATH500/3_1000.jsonl,85
Mistral,origin,3,3_1000#86,88,244,332,1,MISTRAL/origin/MATH500/3_1000.jsonl,86
Mistral,origin,3,3_1000#87,67,249,316,1,MISTRAL/origin/MATH500/3_1000.jsonl,87
Mistral,origin,3,3_1000#88,50,477,527,1,MISTRAL/origin/MATH500/3_1000.jsonl,88
Mistral,origin,3,3_1000#89,105,539,644,0,MISTRAL/origin/MATH500/3_1000.jsonl,89
Mistral,origin,3,3_1000#90,53,759,812,1,MISTRAL/origin/MATH500/3_1000.jsonl,90
Mistral,origin,3,3_1000#91,70,223,293,1,MISTRAL/origin/MATH500/3_1000.jsonl,91
Mistral,origin,3,3_1000#92,69,250,319,1,MISTRAL/origin/MATH500/3_1000.jsonl,92
Mistral,origin,3,3_1000#93,68,612,680,0,MISTRAL/origin/MATH500/3_1000.jsonl,93
Mistral,origin,3,3_1000#94,71,391,462,1,MISTRAL/origin/MATH500/3_1000.jsonl,94
Mistral,origin,3,3_1000#95,390,353,743,0,MISTRAL/origin/MATH500/3_1000.jsonl,95
Mistral,origin,3,3_1000#96,92,562,654,1,MISTRAL/origin/MATH500/3_1000.jsonl,96
Mistral,origin,3,3_1000#97,131,436,567,0,MISTRAL/origin/MATH500/3_1000.jsonl,97
Mistral,origin,3,3_1000#98,74,262,336,1,MISTRAL/origin/MATH500/3_1000.jsonl,98
Mistral,origin,3,3_1000#99,46,121,167,0,MISTRAL/origin/MATH500/3_1000.jsonl,99
Mistral,origin,3,3_1000#100,104,494,598,0,MISTRAL/origin/MATH500/3_1000.jsonl,100
Mistral,origin,6,6_1000#1,76,240,316,1,MISTRAL/origin/MATH500/6_1000.jsonl,1
Mistral,origin,6,6_1000#2,124,630,754,1,MISTRAL/origin/MATH500/6_1000.jsonl,2
Mistral,origin,6,6_1000#3,74,381,455,1,MISTRAL/origin/MATH500/6_1000.jsonl,3
Mistral,origin,6,6_1000#4,42,303,345,1,MISTRAL/origin/MATH500/6_1000.jsonl,4
Mistral,origin,6,6_1000#5,378,467,845,1,MISTRAL/origin/MATH500/6_1000.jsonl,5
Mistral,origin,6,6_1000#6,69,195,264,1,MISTRAL/origin/MATH500/6_1000.jsonl,6
Mistral,origin,6,6_1000#7,47,341,388,1,MISTRAL/origin/MATH500/6_1000.jsonl,7
Mistral,origin,6,6_1000#8,92,1000,1092,0,MISTRAL/origin/MATH500/6_1000.jsonl,8
Mistral,origin,6,6_1000#9,62,413,475,1,MISTRAL/origin/MATH500/6_1000.jsonl,9
Mistral,origin,6,6_1000#10,170,1000,1170,0,MISTRAL/origin/MATH500/6_1000.jsonl,10
Mistral,origin,6,6_1000#11,53,313,366,1,MISTRAL/origin/MATH500/6_1000.jsonl,11
Mistral,origin,6,6_1000#12,86,509,595,0,MISTRAL/origin/MATH500/6_1000.jsonl,12
Mistral,origin,6,6_1000#13,99,401,500,1,MISTRAL/origin/MATH500/6_1000.jsonl,13
Mistral,origin,6,6_1000#14,206,172,378,1,MISTRAL/origin/MATH500/6_1000.jsonl,14
Mistral,origin,6,6_1000#15,147,152,299,0,MISTRAL/origin/MATH500/6_1000.jsonl,15
Mistral,origin,6,6_1000#16,211,575,786,1,MISTRAL/origin/MATH500/6_1000.jsonl,16
Mistral,origin,6,6_1000#17,51,260,311,1,MISTRAL/origin/MATH500/6_1000.jsonl,17
Mistral,origin,6,6_1000#18,252,497,749,1,MISTRAL/origin/MATH500/6_1000.jsonl,18
Mistral,origin,6,6_1000#19,180,429,609,0,MISTRAL/origin/MATH500/6_1000.jsonl,19
Mistral,origin,6,6_1000#20,74,724,798,0,MISTRAL/origin/MATH500/6_1000.jsonl,20
Mistral,origin,6,6_1000#21,41,579,620,0,MISTRAL/origin/MATH500/6_1000.jsonl,21
Mistral,origin,6,6_1000#22,56,752,808,1,MISTRAL/origin/MATH500/6_1000.jsonl,22
Mistral,origin,6,6_1000#23,153,651,804,1,MISTRAL/origin/MATH500/6_1000.jsonl,23
Mistral,origin,6,6_1000#24,56,560,616,0,MISTRAL/origin/MATH500/6_1000.jsonl,24
Mistral,origin,6,6_1000#25,129,876,1005,1,MISTRAL/origin/MATH500/6_1000.jsonl,25
Mistral,origin,6,6_1000#26,107,613,720,0,MISTRAL/origin/MATH500/6_1000.jsonl,26
Mistral,origin,6,6_1000#27,80,1000,1080,0,MISTRAL/origin/MATH500/6_1000.jsonl,27
Mistral,origin,6,6_1000#28,113,350,463,1,MISTRAL/origin/MATH500/6_1000.jsonl,28
Mistral,origin,6,6_1000#29,64,297,361,1,MISTRAL/origin/MATH500/6_1000.jsonl,29
Mistral,origin,6,6_1000#30,104,404,508,1,MISTRAL/origin/MATH500/6_1000.jsonl,30
Mistral,origin,6,6_1000#31,51,228,279,1,MISTRAL/origin/MATH500/6_1000.jsonl,31
Mistral,origin,6,6_1000#32,38,460,498,0,MISTRAL/origin/MATH500/6_1000.jsonl,32
Mistral,origin,6,6_1000#33,79,398,477,1,MISTRAL/origin/MATH500/6_1000.jsonl,33
Mistral,origin,6,6_1000#34,75,526,601,0,MISTRAL/origin/MATH500/6_1000.jsonl,34
Mistral,origin,6,6_1000#35,58,667,725,1,MISTRAL/origin/MATH500/6_1000.jsonl,35
Mistral,origin,6,6_1000#36,67,324,391,1,MISTRAL/origin/MATH500/6_1000.jsonl,36
Mistral,origin,6,6_1000#37,57,729,786,0,MISTRAL/origin/MATH500/6_1000.jsonl,37
Mistral,origin,6,6_1000#38,60,318,378,0,MISTRAL/origin/MATH500/6_1000.jsonl,38
Mistral,origin,6,6_1000#39,69,152,221,1,MISTRAL/origin/MATH500/6_1000.jsonl,39
Mistral,origin,6,6_1000#40,55,483,538,1,MISTRAL/origin/MATH500/6_1000.jsonl,40
Mistral,origin,6,6_1000#41,140,250,390,0,MISTRAL/origin/MATH500/6_1000.jsonl,41
Mistral,origin,6,6_1000#42,78,455,533,0,MISTRAL/origin/MATH500/6_1000.jsonl,42
Mistral,origin,6,6_1000#43,66,165,231,1,MISTRAL/origin/MATH500/6_1000.jsonl,43
Mistral,origin,6,6_1000#44,109,1000,1109,0,MISTRAL/origin/MATH500/6_1000.jsonl,44
Mistral,origin,6,6_1000#45,92,421,513,1,MISTRAL/origin/MATH500/6_1000.jsonl,45
Mistral,origin,6,6_1000#46,64,267,331,1,MISTRAL/origin/MATH500/6_1000.jsonl,46
Mistral,origin,6,6_1000#47,70,539,609,1,MISTRAL/origin/MATH500/6_1000.jsonl,47
Mistral,origin,6,6_1000#48,78,507,585,1,MISTRAL/origin/MATH500/6_1000.jsonl,48
Mistral,origin,6,6_1000#49,47,231,278,1,MISTRAL/origin/MATH500/6_1000.jsonl,49
Mistral,origin,6,6_1000#50,54,187,241,1,MISTRAL/origin/MATH500/6_1000.jsonl,50
Mistral,origin,6,6_1000#51,130,753,883,1,MISTRAL/origin/MATH500/6_1000.jsonl,51
Mistral,origin,6,6_1000#52,49,756,805,1,MISTRAL/origin/MATH500/6_1000.jsonl,52
Mistral,origin,6,6_1000#53,57,247,304,1,MISTRAL/origin/MATH500/6_1000.jsonl,53
Mistral,origin,6,6_1000#54,54,159,213,1,MISTRAL/origin/MATH500/6_1000.jsonl,54
Mistral,origin,6,6_1000#55,41,233,274,1,MISTRAL/origin/MATH500/6_1000.jsonl,55
Mistral,origin,6,6_1000#56,79,298,377,1,MISTRAL/origin/MATH500/6_1000.jsonl,56
Mistral,origin,6,6_1000#57,54,120,174,1,MISTRAL/origin/MATH500/6_1000.jsonl,57
Mistral,origin,6,6_1000#58,82,271,353,1,MISTRAL/origin/MATH500/6_1000.jsonl,58
Mistral,origin,6,6_1000#59,44,250,294,1,MISTRAL/origin/MATH500/6_1000.jsonl,59
Mistral,origin,6,6_1000#60,79,373,452,1,MISTRAL/origin/MATH500/6_1000.jsonl,60
Mistral,origin,6,6_1000#61,79,745,824,0,MISTRAL/origin/MATH500/6_1000.jsonl,61
Mistral,origin,6,6_1000#62,96,133,229,1,MISTRAL/origin/MATH500/6_1000.jsonl,62
Mistral,origin,6,6_1000#63,117,936,1053,1,MISTRAL/origin/MATH500/6_1000.jsonl,63
Mistral,origin,6,6_1000#64,115,452,567,0,MISTRAL/origin/MATH500/6_1000.jsonl,64
Mistral,origin,6,6_1000#65,91,1000,1091,0,MISTRAL/origin/MATH500/6_1000.jsonl,65
Mistral,origin,6,6_1000#66,47,138,185,1,MISTRAL/origin/MATH500/6_1000.jsonl,66
Mistral,origin,6,6_1000#67,60,300,360,0,MISTRAL/origin/MATH500/6_1000.jsonl,67
Mistral,origin,6,6_1000#68,76,325,401,0,MISTRAL/origin/MATH500/6_1000.jsonl,68
Mistral,origin,6,6_1000#69,92,1000,1092,0,MISTRAL/origin/MATH500/6_1000.jsonl,69
Mistral,origin,6,6_1000#70,81,359,440,1,MISTRAL/origin/MATH500/6_1000.jsonl,70
Mistral,origin,6,6_1000#71,49,309,358,1,MISTRAL/origin/MATH500/6_1000.jsonl,71
Mistral,origin,6,6_1000#72,55,386,441,0,MISTRAL/origin/MATH500/6_1000.jsonl,72
Mistral,origin,6,6_1000#73,61,281,342,1,MISTRAL/origin/MATH500/6_1000.jsonl,73
Mistral,origin,6,6_1000#74,92,309,401,1,MISTRAL/origin/MATH500/6_1000.jsonl,74
Mistral,origin,6,6_1000#75,51,315,366,1,MISTRAL/origin/MATH500/6_1000.jsonl,75
Mistral,origin,6,6_1000#76,66,269,335,1,MISTRAL/origin/MATH500/6_1000.jsonl,76
Mistral,origin,6,6_1000#77,67,413,480,1,MISTRAL/origin/MATH500/6_1000.jsonl,77
Mistral,origin,6,6_1000#78,46,199,245,1,MISTRAL/origin/MATH500/6_1000.jsonl,78
Mistral,origin,6,6_1000#79,95,971,1066,0,MISTRAL/origin/MATH500/6_1000.jsonl,79
Mistral,origin,6,6_1000#80,48,188,236,1,MISTRAL/origin/MATH500/6_1000.jsonl,80
Mistral,origin,6,6_1000#81,73,860,933,0,MISTRAL/origin/MATH500/6_1000.jsonl,81
Mistral,origin,6,6_1000#82,77,352,429,1,MISTRAL/origin/MATH500/6_1000.jsonl,82
Mistral,origin,6,6_1000#83,113,326,439,0,MISTRAL/origin/MATH500/6_1000.jsonl,83
Mistral,origin,6,6_1000#84,50,597,647,0,MISTRAL/origin/MATH500/6_1000.jsonl,84
Mistral,origin,6,6_1000#85,84,254,338,1,MISTRAL/origin/MATH500/6_1000.jsonl,85
Mistral,origin,6,6_1000#86,88,305,393,1,MISTRAL/origin/MATH500/6_1000.jsonl,86
Mistral,origin,6,6_1000#87,67,260,327,1,MISTRAL/origin/MATH500/6_1000.jsonl,87
Mistral,origin,6,6_1000#88,50,218,268,1,MISTRAL/origin/MATH500/6_1000.jsonl,88
Mistral,origin,6,6_1000#89,105,1000,1105,0,MISTRAL/origin/MATH500/6_1000.jsonl,89
Mistral,origin,6,6_1000#90,53,770,823,1,MISTRAL/origin/MATH500/6_1000.jsonl,90
Mistral,origin,6,6_1000#91,70,223,293,1,MISTRAL/origin/MATH500/6_1000.jsonl,91
Mistral,origin,6,6_1000#92,69,250,319,1,MISTRAL/origin/MATH500/6_1000.jsonl,92
Mistral,origin,6,6_1000#93,68,612,680,0,MISTRAL/origin/MATH500/6_1000.jsonl,93
Mistral,origin,6,6_1000#94,71,357,428,1,MISTRAL/origin/MATH500/6_1000.jsonl,94
Mistral,origin,6,6_1000#95,390,355,745,0,MISTRAL/origin/MATH500/6_1000.jsonl,95
Mistral,origin,6,6_1000#96,92,562,654,1,MISTRAL/origin/MATH500/6_1000.jsonl,96
Mistral,origin,6,6_1000#97,131,1000,1131,0,MISTRAL/origin/MATH500/6_1000.jsonl,97
Mistral,origin,6,6_1000#98,74,242,316,1,MISTRAL/origin/MATH500/6_1000.jsonl,98
Mistral,origin,6,6_1000#99,46,151,197,0,MISTRAL/origin/MATH500/6_1000.jsonl,99
Mistral,origin,6,6_1000#100,104,499,603,0,MISTRAL/origin/MATH500/6_1000.jsonl,100
Mistral,tree,3,3_1000#1,76,214,290,1,MISTRAL/tree/MATH500/3_1000.jsonl,1
Mistral,tree,3,3_1000#2,124,639,763,1,MISTRAL/tree/MATH500/3_1000.jsonl,2
Mistral,tree,3,3_1000#3,74,381,455,1,MISTRAL/tree/MATH500/3_1000.jsonl,3
Mistral,tree,3,3_1000#4,42,303,345,1,MISTRAL/tree/MATH500/3_1000.jsonl,4
Mistral,tree,3,3_1000#5,378,405,783,1,MISTRAL/tree/MATH500/3_1000.jsonl,5
Mistral,tree,3,3_1000#6,69,233,302,1,MISTRAL/tree/MATH500/3_1000.jsonl,6
Mistral,tree,3,3_1000#7,47,341,388,1,MISTRAL/tree/MATH500/3_1000.jsonl,7
Mistral,tree,3,3_1000#8,92,762,854,1,MISTRAL/tree/MATH500/3_1000.jsonl,8
Mistral,tree,3,3_1000#9,62,389,451,1,MISTRAL/tree/MATH500/3_1000.jsonl,9
Mistral,tree,3,3_1000#10,170,1001,1171,0,MISTRAL/tree/MATH500/3_1000.jsonl,10
Mistral,tree,3,3_1000#11,53,330,383,1,MISTRAL/tree/MATH500/3_1000.jsonl,11
Mistral,tree,3,3_1000#12,86,389,475,0,MISTRAL/tree/MATH500/3_1000.jsonl,12
Mistral,tree,3,3_1000#13,99,401,500,1,MISTRAL/tree/MATH500/3_1000.jsonl,13
Mistral,tree,3,3_1000#14,206,190,396,1,MISTRAL/tree/MATH500/3_1000.jsonl,14
Mistral,tree,3,3_1000#15,147,152,299,0,MISTRAL/tree/MATH500/3_1000.jsonl,15
Mistral,tree,3,3_1000#16,211,579,790,0,MISTRAL/tree/MATH500/3_1000.jsonl,16
Mistral,tree,3,3_1000#17,51,250,301,1,MISTRAL/tree/MATH500/3_1000.jsonl,17
Mistral,tree,3,3_1000#18,252,508,760,0,MISTRAL/tree/MATH500/3_1000.jsonl,18
Mistral,tree,3,3_1000#19,180,1001,1181,0,MISTRAL/tree/MATH500/3_1000.jsonl,19
Mistral,tree,3,3_1000#20,74,850,924,0,MISTRAL/tree/MATH500/3_1000.jsonl,20
Mistral,tree,3,3_1000#21,41,173,214,0,MISTRAL/tree/MATH500/3_1000.jsonl,21
Mistral,tree,3,3_1000#22,56,938,994,1,MISTRAL/tree/MATH500/3_1000.jsonl,22
Mistral,tree,3,3_1000#23,153,377,530,0,MISTRAL/tree/MATH500/3_1000.jsonl,23
Mistral,tree,3,3_1000#24,56,352,408,0,MISTRAL/tree/MATH500/3_1000.jsonl,24
Mistral,tree,3,3_1000#25,129,868,997,1,MISTRAL/tree/MATH500/3_1000.jsonl,25
Mistral,tree,3,3_1000#26,107,632,739,0,MISTRAL/tree/MATH500/3_1000.jsonl,26
Mistral,tree,3,3_1000#27,80,909,989,0,MISTRAL/tree/MATH500/3_1000.jsonl,27
Mistral,tree,3,3_1000#28,113,350,463,1,MISTRAL/tree/MATH500/3_1000.jsonl,28
Mistral,tree,3,3_1000#29,64,114,178,1,MISTRAL/tree/MATH500/3_1000.jsonl,29
Mistral,tree,3,3_1000#30,104,395,499,1,MISTRAL/tree/MATH500/3_1000.jsonl,30
Mistral,tree,3,3_1000#31,51,232,283,1,MISTRAL/tree/MATH500/3_1000.jsonl,31
Mistral,tree,3,3_1000#32,38,460,498,0,MISTRAL/tree/MATH500/3_1000.jsonl,32
Mistral,tree,3,3_1000#33,79,398,477,1,MISTRAL/tree/MATH500/3_1000.jsonl,33
Mistral,tree,3,3_1000#34,75,594,669,0,MISTRAL/tree/MATH500/3_1000.jsonl,34
Mistral,tree,3,3_1000#35,58,667,725,1,MISTRAL/tree/MATH500/3_1000.jsonl,35
Mistral,tree,3,3_1000#36,67,337,404,1,MISTRAL/tree/MATH500/3_1000.jsonl,36
Mistral,tree,3,3_1000#37,57,1001,1058,0,MISTRAL/tree/MATH500/3_1000.jsonl,37
Mistral,tree,3,3_1000#38,60,318,378,0,MISTRAL/tree/MATH500/3_1000.jsonl,38
Mistral,tree,3,3_1000#39,69,152,221,1,MISTRAL/tree/MATH500/3_1000.jsonl,39
Mistral,tree,3,3_1000#40,55,285,340,1,MISTRAL/tree/MATH500/3_1000.jsonl,40
Mistral,tree,3,3_1000#41,140,250,390,0,MISTRAL/tree/MATH500/3_1000.jsonl,41
Mistral,tree,3,3_1000#42,78,443,521,0,MISTRAL/tree/MATH500/3_1000.jsonl,42
Mistral,tree,3,3_1000#43,66,165,231,1,MISTRAL/tree/MATH500/3_1000.jsonl,43
Mistral,tree,3,3_1000#44,109,1001,1110,0,MISTRAL/tree/MATH500/3_1000.jsonl,44
Mistral,tree,3,3_1000#45,92,421,513,1,MISTRAL/tree/MATH500/3_1000.jsonl,45
Mistral,tree,3,3_1000#46,64,267,331,1,MISTRAL/tree/MATH500/3_1000.jsonl,46
Mistral,tree,3,3_1000#47,70,539,609,1,MISTRAL/tree/MATH500/3_1000.jsonl,47
Mistral,tree,3,3_1000#48,78,369,447,1,MISTRAL/tree/MATH500/3_1000.jsonl,48
Mistral,tree,3,3_1000#49,47,231,278,1,MISTRAL/tree/MATH500/3_1000.jsonl,49
Mistral,tree,3,3_1000#50,54,187,241,1,MISTRAL/tree/MATH500/3_1000.jsonl,50
Mistral,tree,3,3_1000#51,130,753,883,1,MISTRAL/tree/MATH500/3_1000.jsonl,51
Mistral,tree,3,3_1000#52,49,760,809,1,MISTRAL/tree/MATH500/3_1000.jsonl,52
Mistral,tree,3,3_1000#53,57,187,244,1,MISTRAL/tree/MATH500/3_1000.jsonl,53
Mistral,tree,3,3_1000#54,54,183,237,1,MISTRAL/tree/MATH500/3_1000.jsonl,54
Mistral,tree,3,3_1000#55,41,233,274,1,MISTRAL/tree/MATH500/3_1000.jsonl,55
Mistral,tree,3,3_1000#56,79,295,374,1,MISTRAL/tree/MATH500/3_1000.jsonl,56
Mistral,tree,3,3_1000#57,54,239,293,1,MISTRAL/tree/MATH500/3_1000.jsonl,57
Mistral,tree,3,3_1000#58,82,426,508,1,MISTRAL/tree/MATH500/3_1000.jsonl,58
Mistral,tree,3,3_1000#59,44,315,359,0,MISTRAL/tree/MATH500/3_1000.jsonl,59
Mistral,tree,3,3_1000#60,79,317,396,1,MISTRAL/tree/MATH500/3_1000.jsonl,60
Mistral,tree,3,3_1000#61,79,1001,1080,0,MISTRAL/tree/MATH500/3_1000.jsonl,61
Mistral,tree,3,3_1000#62,96,133,229,1,MISTRAL/tree/MATH500/3_1000.jsonl,62
Mistral,tree,3,3_1000#63,117,938,1055,1,MISTRAL/tree/MATH500/3_1000.jsonl,63
Mistral,tree,3,3_1000#64,115,469,584,0,MISTRAL/tree/MATH500/3_1000.jsonl,64
Mistral,tree,3,3_1000#65,91,856,947,0,MISTRAL/tree/MATH500/3_1000.jsonl,65
Mistral,tree,3,3_1000#66,47,159,206,1,MISTRAL/tree/MATH500/3_1000.jsonl,66
Mistral,tree,3,3_1000#67,60,300,360,0,MISTRAL/tree/MATH500/3_1000.jsonl,67
Mistral,tree,3,3_1000#68,76,195,271,0,MISTRAL/tree/MATH500/3_1000.jsonl,68
Mistral,tree,3,3_1000#69,92,833,925,1,MISTRAL/tree/MATH500/3_1000.jsonl,69
Mistral,tree,3,3_1000#70,81,342,423,1,MISTRAL/tree/MATH500/3_1000.jsonl,70
Mistral,tree,3,3_1000#71,49,288,337,1,MISTRAL/tree/MATH500/3_1000.jsonl,71
Mistral,tree,3,3_1000#72,55,386,441,0,MISTRAL/tree/MATH500/3_1000.jsonl,72
Mistral,tree,3,3_1000#73,61,281,342,1,MISTRAL/tree/MATH500/3_1000.jsonl,73
Mistral,tree,3,3_1000#74,92,261,353,1,MISTRAL/tree/MATH500/3_1000.jsonl,74
Mistral,tree,3,3_1000#75,51,315,366,1,MISTRAL/tree/MATH500/3_1000.jsonl,75
Mistral,tree,3,3_1000#76,66,269,335,1,MISTRAL/tree/MATH500/3_1000.jsonl,76
Mistral,tree,3,3_1000#77,67,248,315,0,MISTRAL/tree/MATH500/3_1000.jsonl,77
Mistral,tree,3,3_1000#78,46,199,245,1,MISTRAL/tree/MATH500/3_1000.jsonl,78
Mistral,tree,3,3_1000#79,95,975,1070,0,MISTRAL/tree/MATH500/3_1000.jsonl,79
Mistral,tree,3,3_1000#80,48,164,212,1,MISTRAL/tree/MATH500/3_1000.jsonl,80
Mistral,tree,3,3_1000#81,73,761,834,0,MISTRAL/tree/MATH500/3_1000.jsonl,81
Mistral,tree,3,3_1000#82,77,491,568,1,MISTRAL/tree/MATH500/3_1000.jsonl,82
Mistral,tree,3,3_1000#83,113,341,454,0,MISTRAL/tree/MATH500/3_1000.jsonl,83
Mistral,tree,3,3_1000#84,50,534,584,0,MISTRAL/tree/MATH500/3_1000.jsonl,84
Mistral,tree,3,3_1000#85,84,316,400,1,MISTRAL/tree/MATH500/3_1000.jsonl,85
Mistral,tree,3,3_1000#86,88,244,332,1,MISTRAL/tree/MATH500/3_1000.jsonl,86
Mistral,tree,3,3_1000#87,67,249,316,1,MISTRAL/tree/MATH500/3_1000.jsonl,87
Mistral,tree,3,3_1000#88,50,477,527,1,MISTRAL/tree/MATH500/3_1000.jsonl,88
Mistral,tree,3,3_1000#89,105,539,644,0,MISTRAL/tree/MATH500/3_1000.jsonl,89
Mistral,tree,3,3_1000#90,53,759,812,1,MISTRAL/tree/MATH500/3_1000.jsonl,90
Mistral,tree,3,3_1000#91,70,223,293,1,MISTRAL/tree/MATH500/3_1000.jsonl,91
Mistral,tree,3,3_1000#92,69,250,319,1,MISTRAL/tree/MATH500/3_1000.jsonl,92
Mistral,tree,3,3_1000#93,68,612,680,0,MISTRAL/tree/MATH500/3_1000.jsonl,93
Mistral,tree,3,3_1000#94,71,391,462,1,MISTRAL/tree/MATH500/3_1000.jsonl,94
Mistral,tree,3,3_1000#95,390,353,743,0,MISTRAL/tree/MATH500/3_1000.jsonl,95
Mistral,tree,3,3_1000#96,92,562,654,1,MISTRAL/tree/MATH500/3_1000.jsonl,96
Mistral,tree,3,3_1000#97,131,436,567,0,MISTRAL/tree/MATH500/3_1000.jsonl,97
Mistral,tree,3,3_1000#98,74,262,336,1,MISTRAL/tree/MATH500/3_1000.jsonl,98
Mistral,tree,3,3_1000#99,46,121,167,0,MISTRAL/tree/MATH500/3_1000.jsonl,99
Mistral,tree,3,3_1000#100,104,494,598,0,MISTRAL/tree/MATH500/3_1000.jsonl,100
Mistral,tree,6,6_1000#1,76,240,316,1,MISTRAL/tree/MATH500/6_1000.jsonl,1
Mistral,tree,6,6_1000#2,124,630,754,1,MISTRAL/tree/MATH500/6_1000.jsonl,2
Mistral,tree,6,6_1000#3,74,381,455,1,MISTRAL/tree/MATH500/6_1000.jsonl,3
Mistral,tree,6,6_1000#4,42,303,345,1,MISTRAL/tree/MATH500/6_1000.jsonl,4
Mistral,tree,6,6_1000#5,378,467,845,1,MISTRAL/tree/MATH500/6_1000.jsonl,5
Mistral,tree,6,6_1000#6,69,195,264,1,MISTRAL/tree/MATH500/6_1000.jsonl,6
Mistral,tree,6,6_1000#7,47,341,388,1,MISTRAL/tree/MATH500/6_1000.jsonl,7
Mistral,tree,6,6_1000#8,92,1001,1093,0,MISTRAL/tree/MATH500/6_1000.jsonl,8
Mistral,tree,6,6_1000#9,62,413,475,1,MISTRAL/tree/MATH500/6_1000.jsonl,9
Mistral,tree,6,6_1000#10,170,1001,1171,0,MISTRAL/tree/MATH500/6_1000.jsonl,10
Mistral,tree,6,6_1000#11,53,313,366,1,MISTRAL/tree/MATH500/6_1000.jsonl,11
Mistral,tree,6,6_1000#12,86,509,595,0,MISTRAL/tree/MATH500/6_1000.jsonl,12
Mistral,tree,6,6_1000#13,99,401,500,1,MISTRAL/tree/MATH500/6_1000.jsonl,13
Mistral,tree,6,6_1000#14,206,197,403,1,MISTRAL/tree/MATH500/6_1000.jsonl,14
Mistral,tree,6,6_1000#15,147,152,299,0,MISTRAL/tree/MATH500/6_1000.jsonl,15
Mistral,tree,6,6_1000#16,211,575,786,1,MISTRAL/tree/MATH500/6_1000.jsonl,16
Mistral,tree,6,6_1000#17,51,260,311,1,MISTRAL/tree/MATH500/6_1000.jsonl,17
Mistral,tree,6,6_1000#18,252,497,749,1,MISTRAL/tree/MATH500/6_1000.jsonl,18
Mistral,tree,6,6_1000#19,180,429,609,0,MISTRAL/tree/MATH500/6_1000.jsonl,19
Mistral,tree,6,6_1000#20,74,724,798,0,MISTRAL/tree/MATH500/6_1000.jsonl,20
Mistral,tree,6,6_1000#21,41,579,620,0,MISTRAL/tree/MATH500/6_1000.jsonl,21
Mistral,tree,6,6_1000#22,56,752,808,1,MISTRAL/tree/MATH500/6_1000.jsonl,22
Mistral,tree,6,6_1000#23,153,651,804,1,MISTRAL/tree/MATH500/6_1000.jsonl,23
Mistral,tree,6,6_1000#24,56,560,616,0,MISTRAL/tree/MATH500/6_1000.jsonl,24
Mistral,tree,6,6_1000#25,129,876,1005,1,MISTRAL/tree/MATH500/6_1000.jsonl,25
Mistral,tree,6,6_1000#26,107,630,737,0,MISTRAL/tree/MATH500/6_1000.jsonl,26
Mistral,tree,6,6_1000#27,80,1001,1081,0,MISTRAL/tree/MATH500/6_1000.jsonl,27
Mistral,tree,6,6_1000#28,113,350,463,1,MISTRAL/tree/MATH500/6_1000.jsonl,28
Mistral,tree,6,6_1000#29,64,289,353,1,MISTRAL/tree/MATH500/6_1000.jsonl,29
Mistral,tree,6,6_1000#30,104,404,508,1,MISTRAL/tree/MATH500/6_1000.jsonl,30
Mistral,tree,6,6_1000#31,51,228,279,1,MISTRAL/tree/MATH500/6_1000.jsonl,31
Mistral,tree,6,6_1000#32,38,460,498,0,MISTRAL/tree/MATH500/6_1000.jsonl,32
Mistral,tree,6,6_1000#33,79,398,477,1,MISTRAL/tree/MATH500/6_1000.jsonl,33
Mistral,tree,6,6_1000#34,75,526,601,0,MISTRAL/tree/MATH500/6_1000.jsonl,34
Mistral,tree,6,6_1000#35,58,667,725,1,MISTRAL/tree/MATH500/6_1000.jsonl,35
Mistral,tree,6,6_1000#36,67,324,391,1,MISTRAL/tree/MATH500/6_1000.jsonl,36
Mistral,tree,6,6_1000#37,57,729,786,0,MISTRAL/tree/MATH500/6_1000.jsonl,37
Mistral,tree,6,6_1000#38,60,327,387,0,MISTRAL/tree/MATH500/6_1000.jsonl,38
Mistral,tree,6,6_1000#39,69,152,221,1,MISTRAL/tree/MATH500/6_1000.jsonl,39
Mistral,tree,6,6_1000#40,55,483,538,1,MISTRAL/tree/MATH500/6_1000.jsonl,40
Mistral,tree,6,6_1000#41,140,250,390,0,MISTRAL/tree/MATH500/6_1000.jsonl,41
Mistral,tree,6,6_1000#42,78,455,533,0,MISTRAL/tree/MATH500/6_1000.jsonl,42
Mistral,tree,6,6_1000#43,66,165,231,1,MISTRAL/tree/MATH500/6_1000.jsonl,43
Mistral,tree,6,6_1000#44,109,1001,1110,0,MISTRAL/tree/MATH500/6_1000.jsonl,44
Mistral,tree,6,6_1000#45,92,421,513,1,MISTRAL/tree/MATH500/6_1000.jsonl,45
Mistral,tree,6,6_1000#46,64,267,331,1,MISTRAL/tree/MATH500/6_1000.jsonl,46
Mistral,tree,6,6_1000#47,70,539,609,1,MISTRAL/tree/MATH500/6_1000.jsonl,47
Mistral,tree,6,6_1000#48,78,393,471,0,MISTRAL/tree/MATH500/6_1000.jsonl,48
Mistral,tree,6,6_1000#49,47,234,281,1,MISTRAL/tree/MATH500/6_1000.jsonl,49
Mistral,tree,6,6_1000#50,54,187,241,1,MISTRAL/tree/MATH500/6_1000.jsonl,50
Mistral,tree,6,6_1000#51,130,753,883,1,MISTRAL/tree/MATH500/6_1000.jsonl,51
Mistral,tree,6,6_1000#52,49,624,673,1,MISTRAL/tree/MATH500/6_1000.jsonl,52
Mistral,tree,6,6_1000#53,57,247,304,1,MISTRAL/tree/MATH500/6_1000.jsonl,53
Mistral,tree,6,6_1000#54,54,159,213,1,MISTRAL/tree/MATH500/6_1000.jsonl,54
Mistral,tree,6,6_1000#55,41,233,274,1,MISTRAL/tree/MATH500/6_1000.jsonl,55
Mistral,tree,6,6_1000#56,79,298,377,1,MISTRAL/tree/MATH500/6_1000.jsonl,56
Mistral,tree,6,6_1000#57,54,120,174,1,MISTRAL/tree/MATH500/6_1000.jsonl,57
Mistral,tree,6,6_1000#58,82,271,353,1,MISTRAL/tree/MATH500/6_1000.jsonl,58
Mistral,tree,6,6_1000#59,44,250,294,1,MISTRAL/tree/MATH500/6_1000.jsonl,59
Mistral,tree,6,6_1000#60,79,382,461,1,MISTRAL/tree/MATH500/6_1000.jsonl,60
Mistral,tree,6,6_1000#61,79,745,824,0,MISTRAL/tree/MATH500/6_1000.jsonl,61
Mistral,tree,6,6_1000#62,96,133,229,1,MISTRAL/tree/MATH500/6_1000.jsonl,62
Mistral,tree,6,6_1000#63,117,939,1056,1,MISTRAL/tree/MATH500/6_1000.jsonl,63
Mistral,tree,6,6_1000#64,115,469,584,0,MISTRAL/tree/MATH500/6_1000.jsonl,64
Mistral,tree,6,6_1000#65,91,1001,1092,0,MISTRAL/tree/MATH500/6_1000.jsonl,65
Mistral,tree,6,6_1000#66,47,211,258,1,MISTRAL/tree/MATH500/6_1000.jsonl,66
Mistral,tree,6,6_1000#67,60,300,360,0,MISTRAL/tree/MATH500/6_1000.jsonl,67
Mistral,tree,6,6_1000#68,76,325,401,0,MISTRAL/tree/MATH500/6_1000.jsonl,68
Mistral,tree,6,6_1000#69,92,1001,1093,0,MISTRAL/tree/MATH500/6_1000.jsonl,69
Mistral,tree,6,6_1000#70,81,359,440,1,MISTRAL/tree/MATH500/6_1000.jsonl,70
Mistral,tree,6,6_1000#71,49,309,358,1,MISTRAL/tree/MATH500/6_1000.jsonl,71
Mistral,tree,6,6_1000#72,55,386,441,0,MISTRAL/tree/MATH500/6_1000.jsonl,72
Mistral,tree,6,6_1000#73,61,281,342,1,MISTRAL/tree/MATH500/6_1000.jsonl,73
Mistral,tree,6,6_1000#74,92,309,401,1,MISTRAL/tree/MATH500/6_1000.jsonl,74
Mistral,tree,6,6_1000#75,51,315,366,1,MISTRAL/tree/MATH500/6_1000.jsonl,75
Mistral,tree,6,6_1000#76,66,269,335,1,MISTRAL/tree/MATH500/6_1000.jsonl,76
Mistral,tree,6,6_1000#77,67,312,379,1,MISTRAL/tree/MATH500/6_1000.jsonl,77
Mistral,tree,6,6_1000#78,46,199,245,1,MISTRAL/tree/MATH500/6_1000.jsonl,78
Mistral,tree,6,6_1000#79,95,983,1078,0,MISTRAL/tree/MATH500/6_1000.jsonl,79
Mistral,tree,6,6_1000#80,48,188,236,1,MISTRAL/tree/MATH500/6_1000.jsonl,80
Mistral,tree,6,6_1000#81,73,862,935,0,MISTRAL/tree/MATH500/6_1000.jsonl,81
Mistral,tree,6,6_1000#82,77,352,429,1,MISTRAL/tree/MATH500/6_1000.jsonl,82
Mistral,tree,6,6_1000#83,113,326,439,0,MISTRAL/tree/MATH500/6_1000.jsonl,83
Mistral,tree,6,6_1000#84,50,597,647,0,MISTRAL/tree/MATH500/6_1000.jsonl,84
Mistral,tree,6,6_1000#85,84,254,338,1,MISTRAL/tree/MATH500/6_1000.jsonl,85
Mistral,tree,6,6_1000#86,88,270,358,1,MISTRAL/tree/MATH500/6_1000.jsonl,86
Mistral,tree,6,6_1000#87,67,260,327,1,MISTRAL/tree/MATH500/6_1000.jsonl,87
Mistral,tree,6,6_1000#88,50,218,268,1,MISTRAL/tree/MATH500/6_1000.jsonl,88
Mistral,tree,6,6_1000#89,105,1001,1106,0,MISTRAL/tree/MATH500/6_1000.jsonl,89
Mistral,tree,6,6_1000#90,53,770,823,1,MISTRAL/tree/MATH500/6_1000.jsonl,90
Mistral,tree,6,6_1000#91,70,223,293,1,MISTRAL/tree/MATH500/6_1000.jsonl,91
Mistral,tree,6,6_1000#92,69,256,325,1,MISTRAL/tree/MATH500/6_1000.jsonl,92
Mistral,tree,6,6_1000#93,68,612,680,0,MISTRAL/tree/MATH500/6_1000.jsonl,93
Mistral,tree,6,6_1000#94,71,357,428,1,MISTRAL/tree/MATH500/6_1000.jsonl,94
Mistral,tree,6,6_1000#95,390,355,745,0,MISTRAL/tree/MATH500/6_1000.jsonl,95
Mistral,tree,6,6_1000#96,92,562,654,1,MISTRAL/tree/MATH500/6_1000.jsonl,96
Mistral,tree,6,6_1000#97,131,1001,1132,0,MISTRAL/tree/MATH500/6_1000.jsonl,97
Mistral,tree,6,6_1000#98,74,242,316,1,MISTRAL/tree/MATH500/6_1000.jsonl,98
Mistral,tree,6,6_1000#99,46,151,197,0,MISTRAL/tree/MATH500/6_1000.jsonl,99
Mistral,tree,6,6_1000#100,104,499,603,0,MISTRAL/tree/MATH500/6_1000.jsonl,100
Mistral,sampling,,sample#1,76,206,282,1,MISTRAL/sample/MATH500/sample.jsonl,1
Mistral,sampling,,sample#2,124,697,821,0,MISTRAL/sample/MATH500/sample.jsonl,2
Mistral,sampling,,sample#3,74,406,480,1,MISTRAL/sample/MATH500/sample.jsonl,3
Mistral,sampling,,sample#4,42,130,172,0,MISTRAL/sample/MATH500/sample.jsonl,4
Mistral,sampling,,sample#5,378,414,792,0,MISTRAL/sample/MATH500/sample.jsonl,5
Mistral,sampling,,sample#6,69,184,253,0,MISTRAL/sample/MATH500/sample.jsonl,6
Mistral,sampling,,sample#7,47,467,514,0,MISTRAL/sample/MATH500/sample.jsonl,7
Mistral,sampling,,sample#8,92,565,657,0,MISTRAL/sample/MATH500/sample.jsonl,8
Mistral,sampling,,sample#9,62,342,404,0,MISTRAL/sample/MATH500/sample.jsonl,9
Mistral,sampling,,sample#10,170,553,723,0,MISTRAL/sample/MATH500/sample.jsonl,10
Mistral,sampling,,sample#11,53,533,586,1,MISTRAL/sample/MATH500/sample.jsonl,11
Mistral,sampling,,sample#12,86,488,574,0,MISTRAL/sample/MATH500/sample.jsonl,12
Mistral,sampling,,sample#13,99,181,280,0,MISTRAL/sample/MATH500/sample.jsonl,13
Mistral,sampling,,sample#14,206,222,428,1,MISTRAL/sample/MATH500/sample.jsonl,14
Mistral,sampling,,sample#15,147,113,260,0,MISTRAL/sample/MATH500/sample.jsonl,15
Mistral,sampling,,sample#16,211,439,650,0,MISTRAL/sample/MATH500/sample.jsonl,16
Mistral,sampling,,sample#17,51,261,312,1,MISTRAL/sample/MATH500/sample.jsonl,17
Mistral,sampling,,sample#18,252,356,608,1,MISTRAL/sample/MATH500/sample.jsonl,18
Mistral,sampling,,sample#19,180,171,351,0,MISTRAL/sample/MATH500/sample.jsonl,19
Mistral,sampling,,sample#20,74,661,735,0,MISTRAL/sample/MATH500/sample.jsonl,20
Mistral,sampling,,sample#21,41,308,349,0,MISTRAL/sample/MATH500/sample.jsonl,21
Mistral,sampling,,sample#22,56,513,569,0,MISTRAL/sample/MATH500/sample.jsonl,22
Mistral,sampling,,sample#23,153,430,583,0,MISTRAL/sample/MATH500/sample.jsonl,23
Mistral,sampling,,sample#24,56,324,380,0,MISTRAL/sample/MATH500/sample.jsonl,24
Mistral,sampling,,sample#25,129,777,906,0,MISTRAL/sample/MATH500/sample.jsonl,25
Mistral,sampling,,sample#26,107,472,579,0,MISTRAL/sample/MATH500/sample.jsonl,26
Mistral,sampling,,sample#27,80,418,498,1,MISTRAL/sample/MATH500/sample.jsonl,27
Mistral,sampling,,sample#28,113,365,478,1,MISTRAL/sample/MATH500/sample.jsonl,28
Mistral,sampling,,sample#29,64,151,215,1,MISTRAL/sample/MATH500/sample.jsonl,29
Mistral,sampling,,sample#30,104,242,346,1,MISTRAL/sample/MATH500/sample.jsonl,30
Mistral,sampling,,sample#31,51,255,306,1,MISTRAL/sample/MATH500/sample.jsonl,31
Mistral,sampling,,sample#32,38,233,271,0,MISTRAL/sample/MATH500/sample.jsonl,32
Mistral,sampling,,sample#33,79,274,353,1,MISTRAL/sample/MATH500/sample.jsonl,33
Mistral,sampling,,sample#34,75,781,856,0,MISTRAL/sample/MATH500/sample.jsonl,34
Mistral,sampling,,sample#35,58,541,599,1,MISTRAL/sample/MATH500/sample.jsonl,35
Mistral,sampling,,sample#36,67,440,507,0,MISTRAL/sample/MATH500/sample.jsonl,36
Mistral,sampling,,sample#37,57,699,756,0,MISTRAL/sample/MATH500/sample.jsonl,37
Mistral,sampling,,sample#38,60,215,275,0,MISTRAL/sample/MATH500/sample.jsonl,38
Mistral,sampling,,sample#39,69,249,318,1,MISTRAL/sample/MATH500/sample.jsonl,39
Mistral,sampling,,sample#40,55,332,387,0,MISTRAL/sample/MATH500/sample.jsonl,40
Mistral,sampling,,sample#41,140,424,564,0,MISTRAL/sample/MATH500/sample.jsonl,41
Mistral,sampling,,sample#42,78,426,504,0,MISTRAL/sample/MATH500/sample.jsonl,42
Mistral,sampling,,sample#43,66,144,210,1,MISTRAL/sample/MATH500/sample.jsonl,43
Mistral,sampling,,sample#44,109,512,621,0,MISTRAL/sample/MATH500/sample.jsonl,44
Mistral,sampling,,sample#45,92,401,493,1,MISTRAL/sample/MATH500/sample.jsonl,45
Mistral,sampling,,sample#46,64,317,381,1,MISTRAL/sample/MATH500/sample.jsonl,46
Mistral,sampling,,sample#47,70,232,302,0,MISTRAL/sample/MATH500/sample.jsonl,47
Mistral,sampling,,sample#48,78,391,469,1,MISTRAL/sample/MATH500/sample.jsonl,48
Mistral,sampling,,sample#49,47,233,280,1,MISTRAL/sample/MATH500/sample.jsonl,49
Mistral,sampling,,sample#50,54,270,324,0,MISTRAL/sample/MATH500/sample.jsonl,50
Mistral,sampling,,sample#51,130,669,799,0,MISTRAL/sample/MATH500/sample.jsonl,51
Mistral,sampling,,sample#52,49,325,374,0,MISTRAL/sample/MATH500/sample.jsonl,52
Mistral,sampling,,sample#53,57,248,305,1,MISTRAL/sample/MATH500/sample.jsonl,53
Mistral,sampling,,sample#54,54,151,205,0,MISTRAL/sample/MATH500/sample.jsonl,54
Mistral,sampling,,sample#55,41,342,383,0,MISTRAL/sample/MATH500/sample.jsonl,55
Mistral,sampling,,sample#56,79,270,349,1,MISTRAL/sample/MATH500/sample.jsonl,56
Mistral,sampling,,sample#57,54,336,390,1,MISTRAL/sample/MATH500/sample.jsonl,57
Mistral,sampling,,sample#58,82,261,343,0,MISTRAL/sample/MATH500/sample.jsonl,58
Mistral,sampling,,sample#59,44,133,177,0,MISTRAL/sample/MATH500/sample.jsonl,59
Mistral,sampling,,sample#60,79,315,394,1,MISTRAL/sample/MATH500/sample.jsonl,60
Mistral,sampling,,sample#61,79,658,737,0,MISTRAL/sample/MATH500/sample.jsonl,61
Mistral,sampling,,sample#62,96,569,665,0,MISTRAL/sample/MATH500/sample.jsonl,62
Mistral,sampling,,sample#63,117,788,905,0,MISTRAL/sample/MATH500/sample.jsonl,63
Mistral,sampling,,sample#64,115,512,627,0,MISTRAL/sample/MATH500/sample.jsonl,64
Mistral,sampling,,sample#65,91,585,676,0,MISTRAL/sample/MATH500/sample.jsonl,65
Mistral,sampling,,sample#66,47,228,275,0,MISTRAL/sample/MATH500/sample.jsonl,66
Mistral,sampling,,sample#67,60,276,336,0,MISTRAL/sample/MATH500/sample.jsonl,67
Mistral,sampling,,sample#68,76,394,470,0,MISTRAL/sample/MATH500/sample.jsonl,68
Mistral,sampling,,sample#69,92,346,438,0,MISTRAL/sample/MATH500/sample.jsonl,69
Mistral,sampling,,sample#70,81,303,384,0,MISTRAL/sample/MATH500/sample.jsonl,70
Mistral,sampling,,sample#71,49,224,273,0,MISTRAL/sample/MATH500/sample.jsonl,71
Mistral,sampling,,sample#72,55,272,327,0,MISTRAL/sample/MATH500/sample.jsonl,72
Mistral,sampling,,sample#73,61,329,390,0,MISTRAL/sample/MATH500/sample.jsonl,73
Mistral,sampling,,sample#74,92,259,351,1,MISTRAL/sample/MATH500/sample.jsonl,74
Mistral,sampling,,sample#75,51,366,417,0,MISTRAL/sample/MATH500/sample.jsonl,75
Mistral,sampling,,sample#76,66,317,383,1,MISTRAL/sample/MATH500/sample.jsonl,76
Mistral,sampling,,sample#77,67,307,374,1,MISTRAL/sample/MATH500/sample.jsonl,77
Mistral,sampling,,sample#78,46,156,202,1,MISTRAL/sample/MATH500/sample.jsonl,78
Mistral,sampling,,sample#79,95,610,705,0,MISTRAL/sample/MATH500/sample.jsonl,79
Mistral,sampling,,sample#80,48,165,213,0,MISTRAL/sample/MATH500/sample.jsonl,80
Mistral,sampling,,sample#81,73,497,570,1,MISTRAL/sample/MATH500/sample.jsonl,81
Mistral,sampling,,sample#82,77,263,340,0,MISTRAL/sample/MATH500/sample.jsonl,82
Mistral,sampling,,sample#83,113,451,564,0,MISTRAL/sample/MATH500/sample.jsonl,83
Mistral,sampling,,sample#84,50,343,393,0,MISTRAL/sample/MATH500/sample.jsonl,84
Mistral,sampling,,sample#85,84,444,528,0,MISTRAL/sample/MATH500/sample.jsonl,85
Mistral,sampling,,sample#86,88,212,300,1,MISTRAL/sample/MATH500/sample.jsonl,86
Mistral,sampling,,sample#87,67,294,361,1,MISTRAL/sample/MATH500/sample.jsonl,87
Mistral,sampling,,sample#88,50,405,455,1,MISTRAL/sample/MATH500/sample.jsonl,88
Mistral,sampling,,sample#89,105,495,600,0,MISTRAL/sample/MATH500/sample.jsonl,89
Mistral,sampling,,sample#90,53,807,860,0,MISTRAL/sample/MATH500/sample.jsonl,90
Mistral,sampling,,sample#91,70,221,291,1,MISTRAL/sample/MATH500/sample.jsonl,91
Mistral,sampling,,sample#92,69,317,386,1,MISTRAL/sample/MATH500/sample.jsonl,92
Mistral,sampling,,sample#93,68,548,616,0,MISTRAL/sample/MATH500/sample.jsonl,93
Mistral,sampling,,sample#94,71,527,598,1,MISTRAL/sample/MATH500/sample.jsonl,94
Mistral,sampling,,sample#95,390,469,859,0,MISTRAL/sample/MATH500/sample.jsonl,95
Mistral,sampling,,sample#96,92,532,624,1,MISTRAL/sample/MATH500/sample.jsonl,96
Mistral,sampling,,sample#97,131,897,1028,0,MISTRAL/sample/MATH500/sample.jsonl,97
Mistral,sampling,,sample#98,74,264,338,0,MISTRAL/sample/MATH500/sample.jsonl,98
Mistral,sampling,,sample#99,46,154,200,0,MISTRAL/sample/MATH500/sample.jsonl,99
Mistral,sampling,,sample#100,104,712,816,0,MISTRAL/sample/MATH500/sample.jsonl,100
PHI3.5,origin,15,15_1000#1,71,231,302,0,PHI35/origin/MATH500/15_1000.jsonl,1
PHI3.5,origin,15,15_1000#2,123,861,984,0,PHI35/origin/MATH500/15_1000.jsonl,2
PHI3.5,origin,15,15_1000#3,69,274,343,1,PHI35/origin/MATH500/15_1000.jsonl,3
PHI3.5,origin,15,15_1000#4,37,201,238,1,PHI35/origin/MATH500/15_1000.jsonl,4
PHI3.5,origin,15,15_1000#5,402,327,729,0,PHI35/origin/MATH500/15_1000.jsonl,5
PHI3.5,origin,15,15_1000#6,69,125,194,1,PHI35/origin/MATH500/15_1000.jsonl,6
PHI3.5,origin,15,15_1000#7,41,180,221,1,PHI35/origin/MATH500/15_1000.jsonl,7
PHI3.5,origin,15,15_1000#8,96,298,394,0,PHI35/origin/MATH500/15_1000.jsonl,8
PHI3.5,origin,15,15_1000#9,56,237,293,0,PHI35/origin/MATH500/15_1000.jsonl,9
PHI3.5,origin,15,15_1000#10,172,267,439,0,PHI35/origin/MATH500/15_1000.jsonl,10
PHI3.5,origin,15,15_1000#11,47,192,239,0,PHI35/origin/MATH500/15_1000.jsonl,11
PHI3.5,origin,15,15_1000#12,85,798,883,0,PHI35/origin/MATH500/15_1000.jsonl,12
PHI3.5,origin,15,15_1000#13,95,225,320,1,PHI35/origin/MATH500/15_1000.jsonl,13
PHI3.5,origin,15,15_1000#14,221,142,363,1,PHI35/origin/MATH500/15_1000.jsonl,14
PHI3.5,origin,15,15_1000#15,163,92,255,0,PHI35/origin/MATH500/15_1000.jsonl,15
PHI3.5,origin,15,15_1000#16,233,702,935,0,PHI35/origin/MATH500/15_1000.jsonl,16
PHI3.5,origin,15,15_1000#17,46,102,148,1,PHI35/origin/MATH500/15_1000.jsonl,17
PHI3.5,origin,15,15_1000#18,280,189,469,0,PHI35/origin/MATH500/15_1000.jsonl,18
PHI3.5,origin,15,15_1000#19,187,191,378,1,PHI35/origin/MATH500/15_1000.jsonl,19
PHI3.5,origin,15,15_1000#20,69,373,442,1,PHI35/origin/MATH500/15_1000.jsonl,20
PHI3.5,origin,15,15_1000#21,36,103,139,1,PHI35/origin/MATH500/15_1000.jsonl,21
PHI3.5,origin,15,15_1000#22,50,1000,1050,0,PHI35/origin/MATH500/15_1000.jsonl,22
PHI3.5,origin,15,15_1000#23,159,283,442,0,PHI35/origin/MATH500/15_1000.jsonl,23
PHI3.5,origin,15,15_1000#24,50,337,387,0,PHI35/origin/MATH500/15_1000.jsonl,24
PHI3.5,origin,15,15_1000#25,132,336,468,0,PHI35/origin/MATH500/15_1000.jsonl,25
PHI3.5,origin,15,15_1000#26,107,340,447,0,PHI35/origin/MATH500/15_1000.jsonl,26
PHI3.5,origin,15,15_1000#27,76,333,409,0,PHI35/origin/MATH500/15_1000.jsonl,27
PHI3.5,origin,15,15_1000#28,110,219,329,0,PHI35/origin/MATH500/15_1000.jsonl,28
PHI3.5,origin,15,15_1000#29,58,99,157,1,PHI35/origin/MATH500/15_1000.jsonl,29
PHI3.5,origin,15,15_1000#30,103,548,651,1,PHI35/origin/MATH500/15_1000.jsonl,30
PHI3.5,origin,15,15_1000#31,45,202,247,1,PHI35/origin/MATH500/15_1000.jsonl,31
PHI3.5,origin,15,15_1000#32,32,110,142,0,PHI35/origin/MATH500/15_1000.jsonl,32
PHI3.5,origin,15,15_1000#33,73,120,193,1,PHI35/origin/MATH500/15_1000.jsonl,33
PHI3.5,origin,15,15_1000#34,70,268,338,0,PHI35/origin/MATH500/15_1000.jsonl,34
PHI3.5,origin,15,15_1000#35,52,436,488,0,PHI35/origin/MATH500/15_1000.jsonl,35
PHI3.5,origin,15,15_1000#36,61,306,367,0,PHI35/origin/MATH500/15_1000.jsonl,36
PHI3.5,origin,15,15_1000#37,51,465,516,0,PHI35/origin/MATH500/15_1000.jsonl,37
PHI3.5,origin,15,15_1000#38,57,117,174,1,PHI35/origin/MATH500/15_1000.jsonl,38
PHI3.5,origin,15,15_1000#39,72,95,167,1,PHI35/origin/MATH500/15_1000.jsonl,39
PHI3.5,origin,15,15_1000#40,49,311,360,0,PHI35/origin/MATH500/15_1000.jsonl,40
PHI3.5,origin,15,15_1000#41,137,68,205,1,PHI35/origin/MATH500/15_1000.jsonl,41
PHI3.5,origin,15,15_1000#42,72,584,656,0,PHI35/origin/MATH500/15_1000.jsonl,42
PHI3.5,origin,15,15_1000#43,61,132,193,0,PHI35/origin/MATH500/15_1000.jsonl,43
PHI3.5,origin,15,15_1000#44,108,396,504,0,PHI35/origin/MATH500/15_1000.jsonl,44
PHI3.5,origin,15,15_1000#45,87,248,335,1,PHI35/origin/MATH500/15_1000.jsonl,45
PHI3.5,origin,15,15_1000#46,58,223,281,1,PHI35/origin/MATH500/15_1000.jsonl,46
PHI3.5,origin,15,15_1000#47,64,829,893,0,PHI35/origin/MATH500/15_1000.jsonl,47
PHI3.5,origin,15,15_1000#48,78,216,294,1,PHI35/origin/MATH500/15_1000.jsonl,48
PHI3.5,origin,15,15_1000#49,41,175,216,1,PHI35/origin/MATH500/15_1000.jsonl,49
PHI3.5,origin,15,15_1000#50,47,97,144,1,PHI35/origin/MATH500/15_1000.jsonl,50
PHI3.5,origin,15,15_1000#51,137,456,593,0,PHI35/origin/MATH500/15_1000.jsonl,51
PHI3.5,origin,15,15_1000#52,44,515,559,1,PHI35/origin/MATH500/15_1000.jsonl,52
PHI3.5,origin,15,15_1000#53,51,195,246,1,PHI35/origin/MATH500/15_1000.jsonl,53
PHI3.5,origin,15,15_1000#54,50,97,147,1,PHI35/origin/MATH500/15_1000.jsonl,54
PHI3.5,origin,15,15_1000#55,35,90,125,1,PHI35/origin/MATH500/15_1000.jsonl,55
PHI3.5,origin,15,15_1000#56,75,133,208,1,PHI35/origin/MATH500/15_1000.jsonl,56
PHI3.5,origin,15,15_1000#57,47,67,114,1,PHI35/origin/MATH500/15_1000.jsonl,57
PHI3.5,origin,15,15_1000#58,79,181,260,1,PHI35/origin/MATH500/15_1000.jsonl,58
PHI3.5,origin,15,15_1000#59,39,142,181,1,PHI35/origin/MATH500/15_1000.jsonl,59
PHI3.5,origin,15,15_1000#60,77,159,236,1,PHI35/origin/MATH500/15_1000.jsonl,60
PHI3.5,origin,15,15_1000#61,76,1000,1076,0,PHI35/origin/MATH500/15_1000.jsonl,61
PHI3.5,origin,15,15_1000#62,91,265,356,1,PHI35/origin/MATH500/15_1000.jsonl,62
PHI3.5,origin,15,15_1000#63,123,512,635,0,PHI35/origin/MATH500/15_1000.jsonl,63
PHI3.5,origin,15,15_1000#64,119,332,451,0,PHI35/origin/MATH500/15_1000.jsonl,64
PHI3.5,origin,15,15_1000#65,86,615,701,0,PHI35/origin/MATH500/15_1000.jsonl,65
PHI3.5,origin,15,15_1000#66,41,75,116,1,PHI35/origin/MATH500/15_1000.jsonl,66
PHI3.5,origin,15,15_1000#67,65,225,290,0,PHI35/origin/MATH500/15_1000.jsonl,67
PHI3.5,origin,15,15_1000#68,72,208,280,0,PHI35/origin/MATH500/15_1000.jsonl,68
PHI3.5,origin,15,15_1000#69,88,1000,1088,0,PHI35/origin/MATH500/15_1000.jsonl,69
PHI3.5,origin,15,15_1000#70,78,816,894,0,PHI35/origin/MATH500/15_1000.jsonl,70
PHI3.5,origin,15,15_1000#71,44,145,189,1,PHI35/origin/MATH500/15_1000.jsonl,71
PHI3.5,origin,15,15_1000#72,49,222,271,0,PHI35/origin/MATH500/15_1000.jsonl,72
PHI3.5,origin,15,15_1000#73,57,276,333,1,PHI35/origin/MATH500/15_1000.jsonl,73
PHI3.5,origin,15,15_1000#74,89,176,265,1,PHI35/origin/MATH500/15_1000.jsonl,74
PHI3.5,origin,15,15_1000#75,47,190,237,1,PHI35/origin/MATH500/15_1000.jsonl,75
PHI3.5,origin,15,15_1000#76,62,182,244,0,PHI35/origin/MATH500/15_1000.jsonl,76
PHI3.5,origin,15,15_1000#77,61,85,146,1,PHI35/origin/MATH500/15_1000.jsonl,77
PHI3.5,origin,15,15_1000#78,40,101,141,1,PHI35/origin/MATH500/15_1000.jsonl,78
PHI3.5,origin,15,15_1000#79,95,540,635,0,PHI35/origin/MATH500/15_1000.jsonl,79
PHI3.5,origin,15,15_1000#80,43,94,137,1,PHI35/origin/MATH500/15_1000.jsonl,80
PHI3.5,origin,15,15_1000#81,70,272,342,0,PHI35/origin/MATH500/15_1000.jsonl,81
PHI3.5,origin,15,15_1000#82,72,266,338,1,PHI35/origin/MATH500/15_1000.jsonl,82
PHI3.5,origin,15,15_1000#83,106,201,307,0,PHI35/origin/MATH500/15_1000.jsonl,83
PHI3.5,origin,15,15_1000#84,45,236,281,0,PHI35/origin/MATH500/15_1000.jsonl,84
PHI3.5,origin,15,15_1000#85,79,291,370,1,PHI35/origin/MATH500/15_1000.jsonl,85
PHI3.5,origin,15,15_1000#86,87,255,342,1,PHI35/origin/MATH500/15_1000.jsonl,86
PHI3.5,origin,15,15_1000#87,68,150,218,1,PHI35/origin/MATH500/15_1000.jsonl,87
PHI3.5,origin,15,15_1000#88,45,108,153,1,PHI35/origin/MATH500/15_1000.jsonl,88
PHI3.5,origin,15,15_1000#89,116,243,359,0,PHI35/origin/MATH500/15_1000.jsonl,89
PHI3.5,origin,15,15_1000#90,48,361,409,0,PHI35/origin/MATH500/15_1000.jsonl,90
PHI3.5,origin,15,15_1000#91,64,110,174,1,PHI35/origin/MATH500/15_1000.jsonl,91
PHI3.5,origin,15,15_1000#92,66,107,173,0,PHI35/origin/MATH500/15_1000.jsonl,92
PHI3.5,origin,15,15_1000#93,66,575,641,0,PHI35/origin/MATH500/15_1000.jsonl,93
PHI3.5,origin,15,15_1000#94,65,249,314,1,PHI35/origin/MATH500/15_1000.jsonl,94
PHI3.5,origin,15,15_1000#95,434,466,900,0,PHI35/origin/MATH500/15_1000.jsonl,95
PHI3.5,origin,15,15_1000#96,94,520,614,0,PHI35/origin/MATH500/15_1000.jsonl,96
PHI3.5,origin,15,15_1000#97,131,848,979,0,PHI35/origin/MATH500/15_1000.jsonl,97
PHI3.5,origin,15,15_1000#98,70,204,274,0,PHI35/origin/MATH500/15_1000.jsonl,98
PHI3.5,origin,15,15_1000#99,40,101,141,0,PHI35/origin/MATH500/15_1000.jsonl,99
PHI3.5,origin,15,15_1000#100,108,568,676,0,PHI35/origin/MATH500/15_1000.jsonl,100
PHI3.5,origin,1,1_1000#1,71,196,267,0,PHI35/origin/MATH500/1_1000.jsonl,1
PHI3.5,origin,1,1_1000#2,123,645,768,0,PHI35/origin/MATH500/1_1000.jsonl,2
PHI3.5,origin,1,1_1000#3,69,256,325,1,PHI35/origin/MATH500/1_1000.jsonl,3
PHI3.5,origin,1,1_1000#4,37,163,200,1,PHI35/origin/MATH500/1_1000.jsonl,4
PHI3.5,origin,1,1_1000#5,402,461,863,0,PHI35/origin/MATH500/1_1000.jsonl,5
PHI3.5,origin,1,1_1000#6,69,124,193,1,PHI35/origin/MATH500/1_1000.jsonl,6
PHI3.5,origin,1,1_1000#7,41,196,237,1,PHI35/origin/MATH500/1_1000.jsonl,7
PHI3.5,origin,1,1_1000#8,96,565,661,0,PHI35/origin/MATH500/1_1000.jsonl,8
PHI3.5,origin,1,1_1000#9,56,300,356,1,PHI35/origin/MATH500/1_1000.jsonl,9
PHI3.5,origin,1,1_1000#10,172,204,376,0,PHI35/origin/MATH500/1_1000.jsonl,10
PHI3.5,origin,1,1_1000#11,47,180,227,0,PHI35/origin/MATH500/1_1000.jsonl,11
PHI3.5,origin,1,1_1000#12,85,328,413,0,PHI35/origin/MATH500/1_1000.jsonl,12
PHI3.5,origin,1,1_1000#13,95,294,389,0,PHI35/origin/MATH500/1_1000.jsonl,13
PHI3.5,origin,1,1_1000#14,221,145,366,1,PHI35/origin/MATH500/1_1000.jsonl,14
PHI3.5,origin,1,1_1000#15,163,89,252,0,PHI35/origin/MATH500/1_1000.jsonl,15
PHI3.5,origin,1,1_1000#16,233,548,781,0,PHI35/origin/MATH500/1_1000.jsonl,16
PHI3.5,origin,1,1_1000#17,46,81,127,1,PHI35/origin/MATH500/1_1000.jsonl,17
PHI3.5,origin,1,1_1000#18,280,122,402,0,PHI35/origin/MATH500/1_1000.jsonl,18
PHI3.5,origin,1,1_1000#19,187,280,467,0,PHI35/origin/MATH500/1_1000.jsonl,19
PHI3.5,origin,1,1_1000#20,69,119,188,0,PHI35/origin/MATH500/1_1000.jsonl,20
PHI3.5,origin,1,1_1000#21,36,83,119,1,PHI35/origin/MATH500/1_1000.jsonl,21
PHI3.5,origin,1,1_1000#22,50,565,615,0,PHI35/origin/MATH500/1_1000.jsonl,22
PHI3.5,origin,1,1_1000#23,159,199,358,0,PHI35/origin/MATH500/1_1000.jsonl,23
PHI3.5,origin,1,1_1000#24,50,408,458,0,PHI35/origin/MATH500/1_1000.jsonl,24
PHI3.5,origin,1,1_1000#25,132,315,447,0,PHI35/origin/MATH500/1_1000.jsonl,25
PHI3.5,origin,1,1_1000#26,107,242,349,0,PHI35/origin/MATH500/1_1000.jsonl,26
PHI3.5,origin,1,1_1000#27,76,375,451,0,PHI35/origin/MATH500/1_1000.jsonl,27
PHI3.5,origin,1,1_1000#28,110,219,329,0,PHI35/origin/MATH500/1_1000.jsonl,28
PHI3.5,origin,1,1_1000#29,58,100,158,1,PHI35/origin/MATH500/1_1000.jsonl,29
PHI3.5,origin,1,1_1000#30,103,512,615,1,PHI35/origin/MATH500/1_1000.jsonl,30
PHI3.5,origin,1,1_1000#31,45,171,216,1,PHI35/origin/MATH500/1_1000.jsonl,31
PHI3.5,origin,1,1_1000#32,32,124,156,0,PHI35/origin/MATH500/1_1000.jsonl,32
PHI3.5,origin,1,1_1000#33,73,197,270,0,PHI35/origin/MATH500/1_1000.jsonl,33
PHI3.5,origin,1,1_1000#34,70,311,381,0,PHI35/origin/MATH500/1_1000.jsonl,34
PHI3.5,origin,1,1_1000#35,52,248,300,0,PHI35/origin/MATH500/1_1000.jsonl,35
PHI3.5,origin,1,1_1000#36,61,312,373,0,PHI35/origin/MATH500/1_1000.jsonl,36
PHI3.5,origin,1,1_1000#37,51,443,494,0,PHI35/origin/MATH500/1_1000.jsonl,37
PHI3.5,origin,1,1_1000#38,57,143,200,1,PHI35/origin/MATH500/1_1000.jsonl,38
PHI3.5,origin,1,1_1000#39,72,94,166,1,PHI35/origin/MATH500/1_1000.jsonl,39
PHI3.5,origin,1,1_1000#40,49,192,241,1,PHI35/origin/MATH500/1_1000.jsonl,40
PHI3.5,origin,1,1_1000#41,137,68,205,1,PHI35/origin/MATH500/1_1000.jsonl,41
PHI3.5,origin,1,1_1000#42,72,260,332,1,PHI35/origin/MATH500/1_1000.jsonl,42
PHI3.5,origin,1,1_1000#43,61,110,171,1,PHI35/origin/MATH500/1_1000.jsonl,43
PHI3.5,origin,1,1_1000#44,108,152,260,0,PHI35/origin/MATH500/1_1000.jsonl,44
PHI3.5,origin,1,1_1000#45,87,324,411,1,PHI35/origin/MATH500/1_1000.jsonl,45
PHI3.5,origin,1,1_1000#46,58,266,324,1,PHI35/origin/MATH500/1_1000.jsonl,46
PHI3.5,origin,1,1_1000#47,64,548,612,0,PHI35/origin/MATH500/1_1000.jsonl,47
PHI3.5,origin,1,1_1000#48,78,176,254,1,PHI35/origin/MATH500/1_1000.jsonl,48
PHI3.5,origin,1,1_1000#49,41,169,210,1,PHI35/origin/MATH500/1_1000.jsonl,49
PHI3.5,origin,1,1_1000#50,47,103,150,1,PHI35/origin/MATH500/1_1000.jsonl,50
PHI3.5,origin,1,1_1000#51,137,711,848,0,PHI35/origin/MATH500/1_1000.jsonl,51
PHI3.5,origin,1,1_1000#52,44,470,514,0,PHI35/origin/MATH500/1_1000.jsonl,52
PHI3.5,origin,1,1_1000#53,51,215,266,1,PHI35/origin/MATH500/1_1000.jsonl,53
PHI3.5,origin,1,1_1000#54,50,86,136,1,PHI35/origin/MATH500/1_1000.jsonl,54
PHI3.5,origin,1,1_1000#55,35,90,125,1,PHI35/origin/MATH500/1_1000.jsonl,55
PHI3.5,origin,1,1_1000#56,75,133,208,1,PHI35/origin/MATH500/1_1000.jsonl,56
PHI3.5,origin,1,1_1000#57,47,292,339,0,PHI35/origin/MATH500/1_1000.jsonl,57
PHI3.5,origin,1,1_1000#58,79,260,339,1,PHI35/origin/MATH500/1_1000.jsonl,58
PHI3.5,origin,1,1_1000#59,39,172,211,1,PHI35/origin/MATH500/1_1000.jsonl,59
PHI3.5,origin,1,1_1000#60,77,213,290,1,PHI35/origin/MATH500/1_1000.jsonl,60
PHI3.5,origin,1,1_1000#61,76,735,811,0,PHI35/origin/MATH500/1_1000.jsonl,61
PHI3.5,origin,1,1_1000#62,91,198,289,1,PHI35/origin/MATH500/1_1000.jsonl,62
PHI3.5,origin,1,1_1000#63,123,476,599,0,PHI35/origin/MATH500/1_1000.jsonl,63
PHI3.5,origin,1,1_1000#64,119,722,841,0,PHI35/origin/MATH500/1_1000.jsonl,64
PHI3.5,origin,1,1_1000#65,86,548,634,0,PHI35/origin/MATH500/1_1000.jsonl,65
PHI3.5,origin,1,1_1000#66,41,110,151,1,PHI35/origin/MATH500/1_1000.jsonl,66
PHI3.5,origin,1,1_1000#67,65,225,290,0,PHI35/origin/MATH500/1_1000.jsonl,67
PHI3.5,origin,1,1_1000#68,72,221,293,0,PHI35/origin/MATH500/1_1000.jsonl,68
PHI3.5,origin,1,1_1000#69,88,997,1085,0,PHI35/origin/MATH500/1_1000.jsonl,69
PHI3.5,origin,1,1_1000#70,78,517,595,0,PHI35/origin/MATH500/1_1000.jsonl,70
PHI3.5,origin,1,1_1000#71,44,257,301,1,PHI35/origin/MATH500/1_1000.jsonl,71
PHI3.5,origin,1,1_1000#72,49,222,271,0,PHI35/origin/MATH500/1_1000.jsonl,72
PHI3.5,origin,1,1_1000#73,57,226,283,1,PHI35/origin/MATH500/1_1000.jsonl,73
PHI3.5,origin,1,1_1000#74,89,224,313,0,PHI35/origin/MATH500/1_1000.jsonl,74
PHI3.5,origin,1,1_1000#75,47,190,237,1,PHI35/origin/MATH500/1_1000.jsonl,75
PHI3.5,origin,1,1_1000#76,62,216,278,0,PHI35/origin/MATH500/1_1000.jsonl,76
PHI3.5,origin,1,1_1000#77,61,88,149,0,PHI35/origin/MATH500/1_1000.jsonl,77
PHI3.5,origin,1,1_1000#78,40,99,139,1,PHI35/origin/MATH500/1_1000.jsonl,78
PHI3.5,origin,1,1_1000#79,95,409,504,0,PHI35/origin/MATH500/1_1000.jsonl,79
PHI3.5,origin,1,1_1000#80,43,75,118,1,PHI35/origin/MATH500/1_1000.jsonl,80
PHI3.5,origin,1,1_1000#81,70,356,426,0,PHI35/origin/MATH500/1_1000.jsonl,81
PHI3.5,origin,1,1_1000#82,72,238,310,1,PHI35/origin/MATH500/1_1000.jsonl,82
PHI3.5,origin,1,1_1000#83,106,197,303,0,PHI35/origin/MATH500/1_1000.jsonl,83
PHI3.5,origin,1,1_1000#84,45,105,150,0,PHI35/origin/MATH500/1_1000.jsonl,84
PHI3.5,origin,1,1_1000#85,79,380,459,0,PHI35/origin/MATH500/1_1000.jsonl,85
PHI3.5,origin,1,1_1000#86,87,266,353,1,PHI35/origin/MATH500/1_1000.jsonl,86
PHI3.5,origin,1,1_1000#87,68,215,283,1,PHI35/origin/MATH500/1_1000.jsonl,87
PHI3.5,origin,1,1_1000#88,45,127,172,1,PHI35/origin/MATH500/1_1000.jsonl,88
PHI3.5,origin,1,1_1000#89,116,229,345,0,PHI35/origin/MATH500/1_1000.jsonl,89
PHI3.5,origin,1,1_1000#90,48,239,287,0,PHI35/origin/MATH500/1_1000.jsonl,90
PHI3.5,origin,1,1_1000#91,64,107,171,1,PHI35/origin/MATH500/1_1000.jsonl,91
PHI3.5,origin,1,1_1000#92,66,107,173,0,PHI35/origin/MATH500/1_1000.jsonl,92
PHI3.5,origin,1,1_1000#93,66,505,571,0,PHI35/origin/MATH500/1_1000.jsonl,93
PHI3.5,origin,1,1_1000#94,65,202,267,1,PHI35/origin/MATH500/1_1000.jsonl,94
PHI3.5,origin,1,1_1000#95,434,177,611,0,PHI35/origin/MATH500/1_1000.jsonl,95
PHI3.5,origin,1,1_1000#96,94,994,1088,1,PHI35/origin/MATH500/1_1000.jsonl,96
PHI3.5,origin,1,1_1000#97,131,438,569,0,PHI35/origin/MATH500/1_1000.jsonl,97
PHI3.5,origin,1,1_1000#98,70,233,303,0,PHI35/origin/MATH500/1_1000.jsonl,98
PHI3.5,origin,1,1_1000#99,40,83,123,0,PHI35/origin/MATH500/1_1000.jsonl,99
PHI3.5,origin,1,1_1000#100,108,405,513,0,PHI35/origin/MATH500/1_1000.jsonl,100
PHI3.5,origin,3,3_1000#1,71,237,308,0,PHI35/origin/MATH500/3_1000.jsonl,1
PHI3.5,origin,3,3_1000#2,123,1000,1123,0,PHI35/origin/MATH500/3_1000.jsonl,2
PHI3.5,origin,3,3_1000#3,69,276,345,1,PHI35/origin/MATH500/3_1000.jsonl,3
PHI3.5,origin,3,3_1000#4,37,136,173,1,PHI35/origin/MATH500/3_1000.jsonl,4
PHI3.5,origin,3,3_1000#5,402,327,729,0,PHI35/origin/MATH500/3_1000.jsonl,5
PHI3.5,origin,3,3_1000#6,69,112,181,1,PHI35/origin/MATH500/3_1000.jsonl,6
PHI3.5,origin,3,3_1000#7,41,167,208,0,PHI35/origin/MATH500/3_1000.jsonl,7
PHI3.5,origin,3,3_1000#8,96,788,884,0,PHI35/origin/MATH500/3_1000.jsonl,8
PHI3.5,origin,3,3_1000#9,56,275,331,1,PHI35/origin/MATH500/3_1000.jsonl,9
PHI3.5,origin,3,3_1000#10,172,670,842,0,PHI35/origin/MATH500/3_1000.jsonl,10
PHI3.5,origin,3,3_1000#11,47,192,239,0,PHI35/origin/MATH500/3_1000.jsonl,11
PHI3.5,origin,3,3_1000#12,85,551,636,0,PHI35/origin/MATH500/3_1000.jsonl,12
PHI3.5,origin,3,3_1000#13,95,272,367,1,PHI35/origin/MATH500/3_1000.jsonl,13
PHI3.5,origin,3,3_1000#14,221,142,363,1,PHI35/origin/MATH500/3_1000.jsonl,14
PHI3.5,origin,3,3_1000#15,163,99,262,0,PHI35/origin/MATH500/3_1000.jsonl,15
PHI3.5,origin,3,3_1000#16,233,461,694,0,PHI35/origin/MATH500/3_1000.jsonl,16
PHI3.5,origin,3,3_1000#17,46,117,163,1,PHI35/origin/MATH500/3_1000.jsonl,17
PHI3.5,origin,3,3_1000#18,280,196,476,1,PHI35/origin/MATH500/3_1000.jsonl,18
PHI3.5,origin,3,3_1000#19,187,65,252,0,PHI35/origin/MATH500/3_1000.jsonl,19
PHI3.5,origin,3,3_1000#20,69,180,249,0,PHI35/origin/MATH500/3_1000.jsonl,20
PHI3.5,origin,3,3_1000#21,36,103,139,1,PHI35/origin/MATH500/3_1000.jsonl,21
PHI3.5,origin,3,3_1000#22,50,482,532,0,PHI35/origin/MATH500/3_1000.jsonl,22
PHI3.5,origin,3,3_1000#23,159,297,456,0,PHI35/origin/MATH500/3_1000.jsonl,23
PHI3.5,origin,3,3_1000#24,50,412,462,0,PHI35/origin/MATH500/3_1000.jsonl,24
PHI3.5,origin,3,3_1000#25,132,336,468,0,PHI35/origin/MATH500/3_1000.jsonl,25
PHI3.5,origin,3,3_1000#26,107,144,251,0,PHI35/origin/MATH500/3_1000.jsonl,26
PHI3.5,origin,3,3_1000#27,76,331,407,0,PHI35/origin/MATH500/3_1000.jsonl,27
PHI3.5,origin,3,3_1000#28,110,219,329,0,PHI35/origin/MATH500/3_1000.jsonl,28
PHI3.5,origin,3,3_1000#29,58,100,158,1,PHI35/origin/MATH500/3_1000.jsonl,29
PHI3.5,origin,3,3_1000#30,103,523,626,1,PHI35/origin/MATH500/3_1000.jsonl,30
PHI3.5,origin,3,3_1000#31,45,202,247,1,PHI35/origin/MATH500/3_1000.jsonl,31
PHI3.5,origin,3,3_1000#32,32,144,176,0,PHI35/origin/MATH500/3_1000.jsonl,32
PHI3.5,origin,3,3_1000#33,73,217,290,0,PHI35/origin/MATH500/3_1000.jsonl,33
PHI3.5,origin,3,3_1000#34,70,277,347,0,PHI35/origin/MATH500/3_1000.jsonl,34
PHI3.5,origin,3,3_1000#35,52,524,576,0,PHI35/origin/MATH500/3_1000.jsonl,35
PHI3.5,origin,3,3_1000#36,61,364,425,0,PHI35/origin/MATH500/3_1000.jsonl,36
PHI3.5,origin,3,3_1000#37,51,516,567,0,PHI35/origin/MATH500/3_1000.jsonl,37
PHI3.5,origin,3,3_1000#38,57,148,205,1,PHI35/origin/MATH500/3_1000.jsonl,38
PHI3.5,origin,3,3_1000#39,72,94,166,1,PHI35/origin/MATH500/3_1000.jsonl,39
PHI3.5,origin,3,3_1000#40,49,344,393,0,PHI35/origin/MATH500/3_1000.jsonl,40
PHI3.5,origin,3,3_1000#41,137,68,205,1,PHI35/origin/MATH500/3_1000.jsonl,41
PHI3.5,origin,3,3_1000#42,72,396,468,0,PHI35/origin/MATH500/3_1000.jsonl,42
PHI3.5,origin,3,3_1000#43,61,110,171,1,PHI35/origin/MATH500/3_1000.jsonl,43
PHI3.5,origin,3,3_1000#44,108,379,487,0,PHI35/origin/MATH500/3_1000.jsonl,44
PHI3.5,origin,3,3_1000#45,87,299,386,0,PHI35/origin/MATH500/3_1000.jsonl,45
PHI3.5,origin,3,3_1000#46,58,281,339,1,PHI35/origin/MATH500/3_1000.jsonl,46
PHI3.5,origin,3,3_1000#47,64,804,868,0,PHI35/origin/MATH500/3_1000.jsonl,47
PHI3.5,origin,3,3_1000#48,78,179,257,1,PHI35/origin/MATH500/3_1000.jsonl,48
PHI3.5,origin,3,3_1000#49,41,187,228,1,PHI35/origin/MATH500/3_1000.jsonl,49
PHI3.5,origin,3,3_1000#50,47,97,144,1,PHI35/origin/MATH500/3_1000.jsonl,50
PHI3.5,origin,3,3_1000#51,137,332,469,0,PHI35/origin/MATH500/3_1000.jsonl,51
PHI3.5,origin,3,3_1000#52,44,515,559,1,PHI35/origin/MATH500/3_1000.jsonl,52
PHI3.5,origin,3,3_1000#53,51,222,273,1,PHI35/origin/MATH500/3_1000.jsonl,53
PHI3.5,origin,3,3_1000#54,50,86,136,1,PHI35/origin/MATH500/3_1000.jsonl,54
PHI3.5,origin,3,3_1000#55,35,79,114,1,PHI35/origin/MATH500/3_1000.jsonl,55
PHI3.5,origin,3,3_1000#56,75,133,208,1,PHI35/origin/MATH500/3_1000.jsonl,56
PHI3.5,origin,3,3_1000#57,47,67,114,1,PHI35/origin/MATH500/3_1000.jsonl,57
PHI3.5,origin,3,3_1000#58,79,181,260,1,PHI35/origin/MATH500/3_1000.jsonl,58
PHI3.5,origin,3,3_1000#59,39,142,181,1,PHI35/origin/MATH500/3_1000.jsonl,59
PHI3.5,origin,3,3_1000#60,77,219,296,1,PHI35/origin/MATH500/3_1000.jsonl,60
PHI3.5,origin,3,3_1000#61,76,425,501,0,PHI35/origin/MATH500/3_1000.jsonl,61
PHI3.5,origin,3,3_1000#62,91,186,277,1,PHI35/origin/MATH500/3_1000.jsonl,62
PHI3.5,origin,3,3_1000#63,123,484,607,0,PHI35/origin/MATH500/3_1000.jsonl,63
PHI3.5,origin,3,3_1000#64,119,268,387,0,PHI35/origin/MATH500/3_1000.jsonl,64
PHI3.5,origin,3,3_1000#65,86,582,668,0,PHI35/origin/MATH500/3_1000.jsonl,65
PHI3.5,origin,3,3_1000#66,41,103,144,1,PHI35/origin/MATH500/3_1000.jsonl,66
PHI3.5,origin,3,3_1000#67,65,225,290,0,PHI35/origin/MATH500/3_1000.jsonl,67
PHI3.5,origin,3,3_1000#68,72,221,293,0,PHI35/origin/MATH500/3_1000.jsonl,68
PHI3.5,origin,3,3_1000#69,88,474,562,0,PHI35/origin/MATH500/3_1000.jsonl,69
PHI3.5,origin,3,3_1000#70,78,1000,1078,0,PHI35/origin/MATH500/3_1000.jsonl,70
PHI3.5,origin,3,3_1000#71,44,127,171,1,PHI35/origin/MATH500/3_1000.jsonl,71
PHI3.5,origin,3,3_1000#72,49,222,271,0,PHI35/origin/MATH500/3_1000.jsonl,72
PHI3.5,origin,3,3_1000#73,57,202,259,1,PHI35/origin/MATH500/3_1000.jsonl,73
PHI3.5,origin,3,3_1000#74,89,191,280,1,PHI35/origin/MATH500/3_1000.jsonl,74
PHI3.5,origin,3,3_1000#75,47,188,235,1,PHI35/origin/MATH500/3_1000.jsonl,75
PHI3.5,origin,3,3_1000#76,62,215,277,0,PHI35/origin/MATH500/3_1000.jsonl,76
PHI3.5,origin,3,3_1000#77,61,85,146,1,PHI35/origin/MATH500/3_1000.jsonl,77
PHI3.5,origin,3,3_1000#78,40,101,141,1,PHI35/origin/MATH500/3_1000.jsonl,78
PHI3.5,origin,3,3_1000#79,95,502,597,0,PHI35/origin/MATH500/3_1000.jsonl,79
PHI3.5,origin,3,3_1000#80,43,75,118,1,PHI35/origin/MATH500/3_1000.jsonl,80
PHI3.5,origin,3,3_1000#81,70,294,364,0,PHI35/origin/MATH500/3_1000.jsonl,81
PHI3.5,origin,3,3_1000#82,72,266,338,1,PHI35/origin/MATH500/3_1000.jsonl,82
PHI3.5,origin,3,3_1000#83,106,197,303,0,PHI35/origin/MATH500/3_1000.jsonl,83
PHI3.5,origin,3,3_1000#84,45,304,349,0,PHI35/origin/MATH500/3_1000.jsonl,84
PHI3.5,origin,3,3_1000#85,79,342,421,0,PHI35/origin/MATH500/3_1000.jsonl,85
PHI3.5,origin,3,3_1000#86,87,255,342,1,PHI35/origin/MATH500/3_1000.jsonl,86
PHI3.5,origin,3,3_1000#87,68,158,226,1,PHI35/origin/MATH500/3_1000.jsonl,87
PHI3.5,origin,3,3_1000#88,45,108,153,1,PHI35/origin/MATH500/3_1000.jsonl,88
PHI3.5,origin,3,3_1000#89,116,229,345,0,PHI35/origin/MATH500/3_1000.jsonl,89
PHI3.5,origin,3,3_1000#90,48,511,559,0,PHI35/origin/MATH500/3_1000.jsonl,90
PHI3.5,origin,3,3_1000#91,64,110,174,1,PHI35/origin/MATH500/3_1000.jsonl,91
PHI3.5,origin,3,3_1000#92,66,107,173,0,PHI35/origin/MATH500/3_1000.jsonl,92
PHI3.5,origin,3,3_1000#93,66,493,559,0,PHI35/origin/MATH500/3_1000.jsonl,93
PHI3.5,origin,3,3_1000#94,65,202,267,1,PHI35/origin/MATH500/3_1000.jsonl,94
PHI3.5,origin,3,3_1000#95,434,259,693,0,PHI35/origin/MATH500/3_1000.jsonl,95
PHI3.5,origin,3,3_1000#96,94,843,937,0,PHI35/origin/MATH500/3_1000.jsonl,96
PHI3.5,origin,3,3_1000#97,131,759,890,0,PHI35/origin/MATH500/3_1000.jsonl,97
PHI3.5,origin,3,3_1000#98,70,264,334,0,PHI35/origin/MATH500/3_1000.jsonl,98
PHI3.5,origin,3,3_1000#99,40,108,148,0,PHI35/origin/MATH500/3_1000.jsonl,99
PHI3.5,origin,3,3_1000#100,108,484,592,0,PHI35/origin/MATH500/3_1000.jsonl,100
PHI3.5,origin,9,9_1000#1,71,231,302,0,PHI35/origin/MATH500/9_1000.jsonl,1
PHI3.5,origin,9,9_1000#2,123,891,1014,0,PHI35/origin/MATH500/9_1000.jsonl,2
PHI3.5,origin,9,9_1000#3,69,276,345,1,PHI35/origin/MATH500/9_1000.jsonl,3
PHI3.5,origin,9,9_1000#4,37,122,159,1,PHI35/origin/MATH500/9_1000.jsonl,4
PHI3.5,origin,9,9_1000#5,402,327,729,0,PHI35/origin/MATH500/9_1000.jsonl,5
PHI3.5,origin,9,9_1000#6,69,109,178,1,PHI35/origin/MATH500/9_1000.jsonl,6
PHI3.5,origin,9,9_1000#7,41,180,221,1,PHI35/origin/MATH500/9_1000.jsonl,7
PHI3.5,origin,9,9_1000#8,96,661,757,0,PHI35/origin/MATH500/9_1000.jsonl,8
PHI3.5,origin,9,9_1000#9,56,223,279,0,PHI35/origin/MATH500/9_1000.jsonl,9
PHI3.5,origin,9,9_1000#10,172,267,439,0,PHI35/origin/MATH500/9_1000.jsonl,10
PHI3.5,origin,9,9_1000#11,47,192,239,0,PHI35/origin/MATH500/9_1000.jsonl,11
PHI3.5,origin,9,9_1000#12,85,1000,1085,0,PHI35/origin/MATH500/9_1000.jsonl,12
PHI3.5,origin,9,9_1000#13,95,225,320,1,PHI35/origin/MATH500/9_1000.jsonl,13
PHI3.5,origin,9,9_1000#14,221,142,363,1,PHI35/origin/MATH500/9_1000.jsonl,14
PHI3.5,origin,9,9_1000#15,163,92,255,0,PHI35/origin/MATH500/9_1000.jsonl,15
PHI3.5,origin,9,9_1000#16,233,848,1081,0,PHI35/origin/MATH500/9_1000.jsonl,16
PHI3.5,origin,9,9_1000#17,46,102,148,1,PHI35/origin/MATH500/9_1000.jsonl,17
PHI3.5,origin,9,9_1000#18,280,189,469,0,PHI35/origin/MATH500/9_1000.jsonl,18
PHI3.5,origin,9,9_1000#19,187,113,300,0,PHI35/origin/MATH500/9_1000.jsonl,19
PHI3.5,origin,9,9_1000#20,69,180,249,0,PHI35/origin/MATH500/9_1000.jsonl,20
PHI3.5,origin,9,9_1000#21,36,103,139,1,PHI35/origin/MATH500/9_1000.jsonl,21
PHI3.5,origin,9,9_1000#22,50,466,516,0,PHI35/origin/MATH500/9_1000.jsonl,22
PHI3.5,origin,9,9_1000#23,159,283,442,0,PHI35/origin/MATH500/9_1000.jsonl,23
PHI3.5,origin,9,9_1000#24,50,412,462,0,PHI35/origin/MATH500/9_1000.jsonl,24
PHI3.5,origin,9,9_1000#25,132,371,503,0,PHI35/origin/MATH500/9_1000.jsonl,25
PHI3.5,origin,9,9_1000#26,107,1000,1107,0,PHI35/origin/MATH500/9_1000.jsonl,26
PHI3.5,origin,9,9_1000#27,76,330,406,0,PHI35/origin/MATH500/9_1000.jsonl,27
PHI3.5,origin,9,9_1000#28,110,219,329,0,PHI35/origin/MATH500/9_1000.jsonl,28
PHI3.5,origin,9,9_1000#29,58,97,155,1,PHI35/origin/MATH500/9_1000.jsonl,29
PHI3.5,origin,9,9_1000#30,103,546,649,1,PHI35/origin/MATH500/9_1000.jsonl,30
PHI3.5,origin,9,9_1000#31,45,202,247,1,PHI35/origin/MATH500/9_1000.jsonl,31
PHI3.5,origin,9,9_1000#32,32,144,176,0,PHI35/origin/MATH500/9_1000.jsonl,32
PHI3.5,origin,9,9_1000#33,73,120,193,1,PHI35/origin/MATH500/9_1000.jsonl,33
PHI3.5,origin,9,9_1000#34,70,268,338,0,PHI35/origin/MATH500/9_1000.jsonl,34
PHI3.5,origin,9,9_1000#35,52,499,551,0,PHI35/origin/MATH500/9_1000.jsonl,35
PHI3.5,origin,9,9_1000#36,61,306,367,0,PHI35/origin/MATH500/9_1000.jsonl,36
PHI3.5,origin,9,9_1000#37,51,481,532,0,PHI35/origin/MATH500/9_1000.jsonl,37
PHI3.5,origin,9,9_1000#38,57,146,203,1,PHI35/origin/MATH500/9_1000.jsonl,38
PHI3.5,origin,9,9_1000#39,72,100,172,1,PHI35/origin/MATH500/9_1000.jsonl,39
PHI3.5,origin,9,9_1000#40,49,311,360,0,PHI35/origin/MATH500/9_1000.jsonl,40
PHI3.5,origin,9,9_1000#41,137,68,205,1,PHI35/origin/MATH500/9_1000.jsonl,41
PHI3.5,origin,9,9_1000#42,72,580,652,0,PHI35/origin/MATH500/9_1000.jsonl,42
PHI3.5,origin,9,9_1000#43,61,119,180,1,PHI35/origin/MATH500/9_1000.jsonl,43
PHI3.5,origin,9,9_1000#44,108,396,504,0,PHI35/origin/MATH500/9_1000.jsonl,44
PHI3.5,origin,9,9_1000#45,87,248,335,1,PHI35/origin/MATH500/9_1000.jsonl,45
PHI3.5,origin,9,9_1000#46,58,273,331,1,PHI35/origin/MATH500/9_1000.jsonl,46
PHI3.5,origin,9,9_1000#47,64,786,850,0,PHI35/origin/MATH500/9_1000.jsonl,47
PHI3.5,origin,9,9_1000#48,78,221,299,1,PHI35/origin/MATH500/9_1000.jsonl,48
PHI3.5,origin,9,9_1000#49,41,175,216,1,PHI35/origin/MATH500/9_1000.jsonl,49
PHI3.5,origin,9,9_1000#50,47,97,144,1,PHI35/origin/MATH500/9_1000.jsonl,50
PHI3.5,origin,9,9_1000#51,137,487,624,0,PHI35/origin/MATH500/9_1000.jsonl,51
PHI3.5,origin,9,9_1000#52,44,459,503,0,PHI35/origin/MATH500/9_1000.jsonl,52
PHI3.5,origin,9,9_1000#53,51,199,250,1,PHI35/origin/MATH500/9_1000.jsonl,53
PHI3.5,origin,9,9_1000#54,50,70,120,1,PHI35/origin/MATH500/9_1000.jsonl,54
PHI3.5,origin,9,9_1000#55,35,79,114,1,PHI35/origin/MATH500/9_1000.jsonl,55
PHI3.5,origin,9,9_1000#56,75,133,208,1,PHI35/origin/MATH500/9_1000.jsonl,56
PHI3.5,origin,9,9_1000#57,47,67,114,1,PHI35/origin/MATH500/9_1000.jsonl,57
PHI3.5,origin,9,9_1000#58,79,181,260,1,PHI35/origin/MATH500/9_1000.jsonl,58
PHI3.5,origin,9,9_1000#59,39,167,206,1,PHI35/origin/MATH500/9_1000.jsonl,59
PHI3.5,origin,9,9_1000#60,77,197,274,1,PHI35/origin/MATH500/9_1000.jsonl,60
PHI3.5,origin,9,9_1000#61,76,606,682,0,PHI35/origin/MATH500/9_1000.jsonl,61
PHI3.5,origin,9,9_1000#62,91,265,356,1,PHI35/origin/MATH500/9_1000.jsonl,62
PHI3.5,origin,9,9_1000#63,123,512,635,0,PHI35/origin/MATH500/9_1000.jsonl,63
PHI3.5,origin,9,9_1000#64,119,245,364,0,PHI35/origin/MATH500/9_1000.jsonl,64
PHI3.5,origin,9,9_1000#65,86,605,691,0,PHI35/origin/MATH500/9_1000.jsonl,65
PHI3.5,origin,9,9_1000#66,41,67,108,1,PHI35/origin/MATH500/9_1000.jsonl,66
PHI3.5,origin,9,9_1000#67,65,225,290,0,PHI35/origin/MATH500/9_1000.jsonl,67
PHI3.5,origin,9,9_1000#68,72,208,280,0,PHI35/origin/MATH500/9_1000.jsonl,68
PHI3.5,origin,9,9_1000#69,88,547,635,0,PHI35/origin/MATH500/9_1000.jsonl,69
PHI3.5,origin,9,9_1000#70,78,813,891,0,PHI35/origin/MATH500/9_1000.jsonl,70
PHI3.5,origin,9,9_1000#71,44,125,169,1,PHI35/origin/MATH500/9_1000.jsonl,71
PHI3.5,origin,9,9_1000#72,49,223,272,0,PHI35/origin/MATH500/9_1000.jsonl,72
PHI3.5,origin,9,9_1000#73,57,276,333,1,PHI35/origin/MATH500/9_1000.jsonl,73
PHI3.5,origin,9,9_1000#74,89,176,265,1,PHI35/origin/MATH500/9_1000.jsonl,74
PHI3.5,origin,9,9_1000#75,47,188,235,1,PHI35/origin/MATH500/9_1000.jsonl,75
PHI3.5,origin,9,9_1000#76,62,182,244,0,PHI35/origin/MATH500/9_1000.jsonl,76
PHI3.5,origin,9,9_1000#77,61,85,146,1,PHI35/origin/MATH500/9_1000.jsonl,77
PHI3.5,origin,9,9_1000#78,40,101,141,1,PHI35/origin/MATH500/9_1000.jsonl,78
PHI3.5,origin,9,9_1000#79,95,539,634,0,PHI35/origin/MATH500/9_1000.jsonl,79
PHI3.5,origin,9,9_1000#80,43,77,120,1,PHI35/origin/MATH500/9_1000.jsonl,80
PHI3.5,origin,9,9_1000#81,70,262,332,0,PHI35/origin/MATH500/9_1000.jsonl,81
PHI3.5,origin,9,9_1000#82,72,266,338,1,PHI35/origin/MATH500/9_1000.jsonl,82
PHI3.5,origin,9,9_1000#83,106,201,307,0,PHI35/origin/MATH500/9_1000.jsonl,83
PHI3.5,origin,9,9_1000#84,45,568,613,0,PHI35/origin/MATH500/9_1000.jsonl,84
PHI3.5,origin,9,9_1000#85,79,480,559,0,PHI35/origin/MATH500/9_1000.jsonl,85
PHI3.5,origin,9,9_1000#86,87,255,342,1,PHI35/origin/MATH500/9_1000.jsonl,86
PHI3.5,origin,9,9_1000#87,68,157,225,1,PHI35/origin/MATH500/9_1000.jsonl,87
PHI3.5,origin,9,9_1000#88,45,108,153,1,PHI35/origin/MATH500/9_1000.jsonl,88
PHI3.5,origin,9,9_1000#89,116,243,359,0,PHI35/origin/MATH500/9_1000.jsonl,89
PHI3.5,origin,9,9_1000#90,48,361,409,0,PHI35/origin/MATH500/9_1000.jsonl,90
PHI3.5,origin,9,9_1000#91,64,110,174,1,PHI35/origin/MATH500/9_1000.jsonl,91
PHI3.5,origin,9,9_1000#92,66,107,173,0,PHI35/origin/MATH500/9_1000.jsonl,92
PHI3.5,origin,9,9_1000#93,66,600,666,0,PHI35/origin/MATH500/9_1000.jsonl,93
PHI3.5,origin,9,9_1000#94,65,220,285,1,PHI35/origin/MATH500/9_1000.jsonl,94
PHI3.5,origin,9,9_1000#95,434,466,900,0,PHI35/origin/MATH500/9_1000.jsonl,95
PHI3.5,origin,9,9_1000#96,94,522,616,0,PHI35/origin/MATH500/9_1000.jsonl,96
PHI3.5,origin,9,9_1000#97,131,838,969,0,PHI35/origin/MATH500/9_1000.jsonl,97
PHI3.5,origin,9,9_1000#98,70,264,334,0,PHI35/origin/MATH500/9_1000.jsonl,98
PHI3.5,origin,9,9_1000#99,40,107,147,0,PHI35/origin/MATH500/9_1000.jsonl,99
PHI3.5,origin,9,9_1000#100,108,568,676,0,PHI35/origin/MATH500/9_1000.jsonl,100
PHI3.5,tree,15,15_1000#1,71,231,302,0,PHI35/tree/MATH500/15_1000.jsonl,1
PHI3.5,tree,15,15_1000#2,123,861,984,0,PHI35/tree/MATH500/15_1000.jsonl,2
PHI3.5,tree,15,15_1000#3,69,274,343,1,PHI35/tree/MATH500/15_1000.jsonl,3
PHI3.5,tree,15,15_1000#4,37,201,238,1,PHI35/tree/MATH500/15_1000.jsonl,4
PHI3.5,tree,15,15_1000#5,402,327,729,0,PHI35/tree/MATH500/15_1000.jsonl,5
PHI3.5,tree,15,15_1000#6,69,126,195,1,PHI35/tree/MATH500/15_1000.jsonl,6
PHI3.5,tree,15,15_1000#7,41,180,221,1,PHI35/tree/MATH500/15_1000.jsonl,7
PHI3.5,tree,15,15_1000#8,96,298,394,0,PHI35/tree/MATH500/15_1000.jsonl,8
PHI3.5,tree,15,15_1000#9,56,237,293,0,PHI35/tree/MATH500/15_1000.jsonl,9
PHI3.5,tree,15,15_1000#10,172,267,439,0,PHI35/tree/MATH500/15_1000.jsonl,10
PHI3.5,tree,15,15_1000#11,47,192,239,0,PHI35/tree/MATH500/15_1000.jsonl,11
PHI3.5,tree,15,15_1000#12,85,832,917,0,PHI35/tree/MATH500/15_1000.jsonl,12
PHI3.5,tree,15,15_1000#13,95,225,320,1,PHI35/tree/MATH500/15_1000.jsonl,13
PHI3.5,tree,15,15_1000#14,221,142,363,1,PHI35/tree/MATH500/15_1000.jsonl,14
PHI3.5,tree,15,15_1000#15,163,92,255,0,PHI35/tree/MATH500/15_1000.jsonl,15
PHI3.5,tree,15,15_1000#16,233,691,924,0,PHI35/tree/MATH500/15_1000.jsonl,16
PHI3.5,tree,15,15_1000#17,46,102,148,1,PHI35/tree/MATH500/15_1000.jsonl,17
PHI3.5,tree,15,15_1000#18,280,189,469,0,PHI35/tree/MATH500/15_1000.jsonl,18
PHI3.5,tree,15,15_1000#19,187,191,378,1,PHI35/tree/MATH500/15_1000.jsonl,19
PHI3.5,tree,15,15_1000#20,69,373,442,1,PHI35/tree/MATH500/15_1000.jsonl,20
PHI3.5,tree,15,15_1000#21,36,103,139,1,PHI35/tree/MATH500/15_1000.jsonl,21
PHI3.5,tree,15,15_1000#22,50,1001,1051,0,PHI35/tree/MATH500/15_1000.jsonl,22
PHI3.5,tree,15,15_1000#23,159,283,442,0,PHI35/tree/MATH500/15_1000.jsonl,23
PHI3.5,tree,15,15_1000#24,50,337,387,0,PHI35/tree/MATH500/15_1000.jsonl,24
PHI3.5,tree,15,15_1000#25,132,336,468,0,PHI35/tree/MATH500/15_1000.jsonl,25
PHI3.5,tree,15,15_1000#26,107,340,447,0,PHI35/tree/MATH500/15_1000.jsonl,26
PHI3.5,tree,15,15_1000#27,76,330,406,0,PHI35/tree/MATH500/15_1000.jsonl,27
PHI3.5,tree,15,15_1000#28,110,219,329,0,PHI35/tree/MATH500/15_1000.jsonl,28
PHI3.5,tree,15,15_1000#29,58,99,157,1,PHI35/tree/MATH500/15_1000.jsonl,29
PHI3.5,tree,15,15_1000#30,103,548,651,1,PHI35/tree/MATH500/15_1000.jsonl,30
PHI3.5,tree,15,15_1000#31,45,202,247,1,PHI35/tree/MATH500/15_1000.jsonl,31
PHI3.5,tree,15,15_1000#32,32,144,176,0,PHI35/tree/MATH500/15_1000.jsonl,32
PHI3.5,tree,15,15_1000#33,73,120,193,1,PHI35/tree/MATH500/15_1000.jsonl,33
PHI3.5,tree,15,15_1000#34,70,268,338,0,PHI35/tree/MATH500/15_1000.jsonl,34
PHI3.5,tree,15,15_1000#35,52,436,488,0,PHI35/tree/MATH500/15_1000.jsonl,35
PHI3.5,tree,15,15_1000#36,61,306,367,0,PHI35/tree/MATH500/15_1000.jsonl,36
PHI3.5,tree,15,15_1000#37,51,465,516,0,PHI35/tree/MATH500/15_1000.jsonl,37
PHI3.5,tree,15,15_1000#38,57,117,174,1,PHI35/tree/MATH500/15_1000.jsonl,38
PHI3.5,tree,15,15_1000#39,72,95,167,1,PHI35/tree/MATH500/15_1000.jsonl,39
PHI3.5,tree,15,15_1000#40,49,311,360,0,PHI35/tree/MATH500/15_1000.jsonl,40
PHI3.5,tree,15,15_1000#41,137,68,205,1,PHI35/tree/MATH500/15_1000.jsonl,41
PHI3.5,tree,15,15_1000#42,72,584,656,0,PHI35/tree/MATH500/15_1000.jsonl,42
PHI3.5,tree,15,15_1000#43,61,132,193,0,PHI35/tree/MATH500/15_1000.jsonl,43
PHI3.5,tree,15,15_1000#44,108,396,504,0,PHI35/tree/MATH500/15_1000.jsonl,44
PHI3.5,tree,15,15_1000#45,87,248,335,1,PHI35/tree/MATH500/15_1000.jsonl,45
PHI3.5,tree,15,15_1000#46,58,223,281,1,PHI35/tree/MATH500/15_1000.jsonl,46
PHI3.5,tree,15,15_1000#47,64,829,893,0,PHI35/tree/MATH500/15_1000.jsonl,47
PHI3.5,tree,15,15_1000#48,78,218,296,1,PHI35/tree/MATH500/15_1000.jsonl,48
PHI3.5,tree,15,15_1000#49,41,175,216,1,PHI35/tree/MATH500/15_1000.jsonl,49
PHI3.5,tree,15,15_1000#50,47,97,144,1,PHI35/tree/MATH500/15_1000.jsonl,50
PHI3.5,tree,15,15_1000#51,137,456,593,0,PHI35/tree/MATH500/15_1000.jsonl,51
PHI3.5,tree,15,15_1000#52,44,515,559,1,PHI35/tree/MATH500/15_1000.jsonl,52
PHI3.5,tree,15,15_1000#53,51,195,246,1,PHI35/tree/MATH500/15_1000.jsonl,53
PHI3.5,tree,15,15_1000#54,50,97,147,1,PHI35/tree/MATH500/15_1000.jsonl,54
PHI3.5,tree,15,15_1000#55,35,90,125,1,PHI35/tree/MATH500/15_1000.jsonl,55
PHI3.5,tree,15,15_1000#56,75,133,208,1,PHI35/tree/MATH500/15_1000.jsonl,56
PHI3.5,tree,15,15_1000#57,47,67,114,1,PHI35/tree/MATH500/15_1000.jsonl,57
PHI3.5,tree,15,15_1000#58,79,181,260,1,PHI35/tree/MATH500/15_1000.jsonl,58
PHI3.5,tree,15,15_1000#59,39,167,206,1,PHI35/tree/MATH500/15_1000.jsonl,59
PHI3.5,tree,15,15_1000#60,77,159,236,1,PHI35/tree/MATH500/15_1000.jsonl,60
PHI3.5,tree,15,15_1000#61,76,1001,1077,0,PHI35/tree/MATH500/15_1000.jsonl,61
PHI3.5,tree,15,15_1000#62,91,265,356,1,PHI35/tree/MATH500/15_1000.jsonl,62
PHI3.5,tree,15,15_1000#63,123,512,635,0,PHI35/tree/MATH500/15_1000.jsonl,63
PHI3.5,tree,15,15_1000#64,119,332,451,0,PHI35/tree/MATH500/15_1000.jsonl,64
PHI3.5,tree,15,15_1000#65,86,615,701,0,PHI35/tree/MATH500/15_1000.jsonl,65
PHI3.5,tree,15,15_1000#66,41,61,102,1,PHI35/tree/MATH500/15_1000.jsonl,66
PHI3.5,tree,15,15_1000#67,65,225,290,0,PHI35/tree/MATH500/15_1000.jsonl,67
PHI3.5,tree,15,15_1000#68,72,208,280,0,PHI35/tree/MATH500/15_1000.jsonl,68
PHI3.5,tree,15,15_1000#69,88,1001,1089,0,PHI35/tree/MATH500/15_1000.jsonl,69
PHI3.5,tree,15,15_1000#70,78,816,894,0,PHI35/tree/MATH500/15_1000.jsonl,70
PHI3.5,tree,15,15_1000#71,44,145,189,1,PHI35/tree/MATH500/15_1000.jsonl,71
PHI3.5,tree,15,15_1000#72,49,222,271,0,PHI35/tree/MATH500/15_1000.jsonl,72
PHI3.5,tree,15,15_1000#73,57,276,333,1,PHI35/tree/MATH500/15_1000.jsonl,73
PHI3.5,tree,15,15_1000#74,89,176,265,1,PHI35/tree/MATH500/15_1000.jsonl,74
PHI3.5,tree,15,15_1000#75,47,190,237,1,PHI35/tree/MATH500/15_1000.jsonl,75
PHI3.5,tree,15,15_1000#76,62,182,244,0,PHI35/tree/MATH500/15_1000.jsonl,76
PHI3.5,tree,15,15_1000#77,61,85,146,1,PHI35/tree/MATH500/15_1000.jsonl,77
PHI3.5,tree,15,15_1000#78,40,101,141,1,PHI35/tree/MATH500/15_1000.jsonl,78
PHI3.5,tree,15,15_1000#79,95,540,635,0,PHI35/tree/MATH500/15_1000.jsonl,79
PHI3.5,tree,15,15_1000#80,43,94,137,1,PHI35/tree/MATH500/15_1000.jsonl,80
PHI3.5,tree,15,15_1000#81,70,272,342,0,PHI35/tree/MATH500/15_1000.jsonl,81
PHI3.5,tree,15,15_1000#82,72,266,338,1,PHI35/tree/MATH500/15_1000.jsonl,82
PHI3.5,tree,15,15_1000#83,106,201,307,0,PHI35/tree/MATH500/15_1000.jsonl,83
PHI3.5,tree,15,15_1000#84,45,236,281,0,PHI35/tree/MATH500/15_1000.jsonl,84
PHI3.5,tree,15,15_1000#85,79,291,370,1,PHI35/tree/MATH500/15_1000.jsonl,85
PHI3.5,tree,15,15_1000#86,87,255,342,1,PHI35/tree/MATH500/15_1000.jsonl,86
PHI3.5,tree,15,15_1000#87,68,150,218,1,PHI35/tree/MATH500/15_1000.jsonl,87
PHI3.5,tree,15,15_1000#88,45,108,153,1,PHI35/tree/MATH500/15_1000.jsonl,88
PHI3.5,tree,15,15_1000#89,116,243,359,0,PHI35/tree/MATH500/15_1000.jsonl,89
PHI3.5,tree,15,15_1000#90,48,361,409,0,PHI35/tree/MATH500/15_1000.jsonl,90
PHI3.5,tree,15,15_1000#91,64,110,174,1,PHI35/tree/MATH500/15_1000.jsonl,91
PHI3.5,tree,15,15_1000#92,66,107,173,0,PHI35/tree/MATH500/15_1000.jsonl,92
PHI3.5,tree,15,15_1000#93,66,575,641,0,PHI35/tree/MATH500/15_1000.jsonl,93
PHI3.5,tree,15,15_1000#94,65,249,314,1,PHI35/tree/MATH500/15_1000.jsonl,94
PHI3.5,tree,15,15_1000#95,434,466,900,0,PHI35/tree/MATH500/15_1000.jsonl,95
PHI3.5,tree,15,15_1000#96,94,520,614,0,PHI35/tree/MATH500/15_1000.jsonl,96
PHI3.5,tree,15,15_1000#97,131,848,979,0,PHI35/tree/MATH500/15_1000.jsonl,97
PHI3.5,tree,15,15_1000#98,70,204,274,0,PHI35/tree/MATH500/15_1000.jsonl,98
PHI3.5,tree,15,15_1000#99,40,101,141,0,PHI35/tree/MATH500/15_1000.jsonl,99
PHI3.5,tree,15,15_1000#100,108,568,676,0,PHI35/tree/MATH500/15_1000.jsonl,100
PHI3.5,tree,3,3_1000#1,71,237,308,0,PHI35/tree/MATH500/3_1000.jsonl,1
PHI3.5,tree,3,3_1000#2,123,1001,1124,0,PHI35/tree/MATH500/3_1000.jsonl,2
PHI3.5,tree,3,3_1000#3,69,276,345,1,PHI35/tree/MATH500/3_1000.jsonl,3
PHI3.5,tree,3,3_1000#4,37,136,173,1,PHI35/tree/MATH500/3_1000.jsonl,4
PHI3.5,tree,3,3_1000#5,402,327,729,0,PHI35/tree/MATH500/3_1000.jsonl,5
PHI3.5,tree,3,3_1000#6,69,112,181,1,PHI35/tree/MATH500/3_1000.jsonl,6
PHI3.5,tree,3,3_1000#7,41,167,208,0,PHI35/tree/MATH500/3_1000.jsonl,7
PHI3.5,tree,3,3_1000#8,96,788,884,0,PHI35/tree/MATH500/3_1000.jsonl,8
PHI3.5,tree,3,3_1000#9,56,300,356,1,PHI35/tree/MATH500/3_1000.jsonl,9
PHI3.5,tree,3,3_1000#10,172,671,843,0,PHI35/tree/MATH500/3_1000.jsonl,10
PHI3.5,tree,3,3_1000#11,47,192,239,0,PHI35/tree/MATH500/3_1000.jsonl,11
PHI3.5,tree,3,3_1000#12,85,551,636,0,PHI35/tree/MATH500/3_1000.jsonl,12
PHI3.5,tree,3,3_1000#13,95,272,367,1,PHI35/tree/MATH500/3_1000.jsonl,13
PHI3.5,tree,3,3_1000#14,221,142,363,1,PHI35/tree/MATH500/3_1000.jsonl,14
PHI3.5,tree,3,3_1000#15,163,108,271,0,PHI35/tree/MATH500/3_1000.jsonl,15
PHI3.5,tree,3,3_1000#16,233,461,694,0,PHI35/tree/MATH500/3_1000.jsonl,16
PHI3.5,tree,3,3_1000#17,46,117,163,1,PHI35/tree/MATH500/3_1000.jsonl,17
PHI3.5,tree,3,3_1000#18,280,196,476,1,PHI35/tree/MATH500/3_1000.jsonl,18
PHI3.5,tree,3,3_1000#19,187,65,252,0,PHI35/tree/MATH500/3_1000.jsonl,19
PHI3.5,tree,3,3_1000#20,69,192,261,0,PHI35/tree/MATH500/3_1000.jsonl,20
PHI3.5,tree,3,3_1000#21,36,103,139,1,PHI35/tree/MATH500/3_1000.jsonl,21
PHI3.5,tree,3,3_1000#22,50,482,532,0,PHI35/tree/MATH500/3_1000.jsonl,22
PHI3.5,tree,3,3_1000#23,159,297,456,0,PHI35/tree/MATH500/3_1000.jsonl,23
PHI3.5,tree,3,3_1000#24,50,412,462,0,PHI35/tree/MATH500/3_1000.jsonl,24
PHI3.5,tree,3,3_1000#25,132,336,468,0,PHI35/tree/MATH500/3_1000.jsonl,25
PHI3.5,tree,3,3_1000#26,107,144,251,0,PHI35/tree/MATH500/3_1000.jsonl,26
PHI3.5,tree,3,3_1000#27,76,331,407,0,PHI35/tree/MATH500/3_1000.jsonl,27
PHI3.5,tree,3,3_1000#28,110,219,329,0,PHI35/tree/MATH500/3_1000.jsonl,28
PHI3.5,tree,3,3_1000#29,58,100,158,1,PHI35/tree/MATH500/3_1000.jsonl,29
PHI3.5,tree,3,3_1000#30,103,523,626,1,PHI35/tree/MATH500/3_1000.jsonl,30
PHI3.5,tree,3,3_1000#31,45,202,247,1,PHI35/tree/MATH500/3_1000.jsonl,31
PHI3.5,tree,3,3_1000#32,32,144,176,0,PHI35/tree/MATH500/3_1000.jsonl,32
PHI3.5,tree,3,3_1000#33,73,217,290,0,PHI35/tree/MATH500/3_1000.jsonl,33
PHI3.5,tree,3,3_1000#34,70,277,347,0,PHI35/tree/MATH500/3_1000.jsonl,34
PHI3.5,tree,3,3_1000#35,52,524,576,0,PHI35/tree/MATH500/3_1000.jsonl,35
PHI3.5,tree,3,3_1000#36,61,364,425,0,PHI35/tree/MATH500/3_1000.jsonl,36
PHI3.5,tree,3,3_1000#37,51,516,567,0,PHI35/tree/MATH500/3_1000.jsonl,37
PHI3.5,tree,3,3_1000#38,57,148,205,1,PHI35/tree/MATH500/3_1000.jsonl,38
PHI3.5,tree,3,3_1000#39,72,94,166,1,PHI35/tree/MATH500/3_1000.jsonl,39
PHI3.5,tree,3,3_1000#40,49,344,393,0,PHI35/tree/MATH500/3_1000.jsonl,40
PHI3.5,tree,3,3_1000#41,137,68,205,1,PHI35/tree/MATH500/3_1000.jsonl,41
PHI3.5,tree,3,3_1000#42,72,396,468,0,PHI35/tree/MATH500/3_1000.jsonl,42
PHI3.5,tree,3,3_1000#43,61,110,171,1,PHI35/tree/MATH500/3_1000.jsonl,43
PHI3.5,tree,3,3_1000#44,108,395,503,0,PHI35/tree/MATH500/3_1000.jsonl,44
PHI3.5,tree,3,3_1000#45,87,299,386,0,PHI35/tree/MATH500/3_1000.jsonl,45
PHI3.5,tree,3,3_1000#46,58,281,339,1,PHI35/tree/MATH500/3_1000.jsonl,46
PHI3.5,tree,3,3_1000#47,64,804,868,0,PHI35/tree/MATH500/3_1000.jsonl,47
PHI3.5,tree,3,3_1000#48,78,179,257,1,PHI35/tree/MATH500/3_1000.jsonl,48
PHI3.5,tree,3,3_1000#49,41,187,228,1,PHI35/tree/MATH500/3_1000.jsonl,49
PHI3.5,tree,3,3_1000#50,47,97,144,1,PHI35/tree/MATH500/3_1000.jsonl,50
PHI3.5,tree,3,3_1000#51,137,332,469,0,PHI35/tree/MATH500/3_1000.jsonl,51
PHI3.5,tree,3,3_1000#52,44,515,559,1,PHI35/tree/MATH500/3_1000.jsonl,52
PHI3.5,tree,3,3_1000#53,51,223,274,1,PHI35/tree/MATH500/3_1000.jsonl,53
PHI3.5,tree,3,3_1000#54,50,100,150,1,PHI35/tree/MATH500/3_1000.jsonl,54
PHI3.5,tree,3,3_1000#55,35,79,114,1,PHI35/tree/MATH500/3_1000.jsonl,55
PHI3.5,tree,3,3_1000#56,75,133,208,1,PHI35/tree/MATH500/3_1000.jsonl,56
PHI3.5,tree,3,3_1000#57,47,67,114,1,PHI35/tree/MATH500/3_1000.jsonl,57
PHI3.5,tree,3,3_1000#58,79,181,260,1,PHI35/tree/MATH500/3_1000.jsonl,58
PHI3.5,tree,3,3_1000#59,39,142,181,1,PHI35/tree/MATH500/3_1000.jsonl,59
PHI3.5,tree,3,3_1000#60,77,219,296,1,PHI35/tree/MATH500/3_1000.jsonl,60
PHI3.5,tree,3,3_1000#61,76,425,501,0,PHI35/tree/MATH500/3_1000.jsonl,61
PHI3.5,tree,3,3_1000#62,91,199,290,1,PHI35/tree/MATH500/3_1000.jsonl,62
PHI3.5,tree,3,3_1000#63,123,484,607,0,PHI35/tree/MATH500/3_1000.jsonl,63
PHI3.5,tree,3,3_1000#64,119,268,387,0,PHI35/tree/MATH500/3_1000.jsonl,64
PHI3.5,tree,3,3_1000#65,86,582,668,0,PHI35/tree/MATH500/3_1000.jsonl,65
PHI3.5,tree,3,3_1000#66,41,103,144,1,PHI35/tree/MATH500/3_1000.jsonl,66
PHI3.5,tree,3,3_1000#67,65,225,290,0,PHI35/tree/MATH500/3_1000.jsonl,67
PHI3.5,tree,3,3_1000#68,72,221,293,0,PHI35/tree/MATH500/3_1000.jsonl,68
PHI3.5,tree,3,3_1000#69,88,474,562,0,PHI35/tree/MATH500/3_1000.jsonl,69
PHI3.5,tree,3,3_1000#70,78,1001,1079,0,PHI35/tree/MATH500/3_1000.jsonl,70
PHI3.5,tree,3,3_1000#71,44,128,172,1,PHI35/tree/MATH500/3_1000.jsonl,71
PHI3.5,tree,3,3_1000#72,49,222,271,0,PHI35/tree/MATH500/3_1000.jsonl,72
PHI3.5,tree,3,3_1000#73,57,202,259,1,PHI35/tree/MATH500/3_1000.jsonl,73
PHI3.5,tree,3,3_1000#74,89,191,280,1,PHI35/tree/MATH500/3_1000.jsonl,74
PHI3.5,tree,3,3_1000#75,47,190,237,1,PHI35/tree/MATH500/3_1000.jsonl,75
PHI3.5,tree,3,3_1000#76,62,215,277,0,PHI35/tree/MATH500/3_1000.jsonl,76
PHI3.5,tree,3,3_1000#77,61,85,146,1,PHI35/tree/MATH500/3_1000.jsonl,77
PHI3.5,tree,3,3_1000#78,40,101,141,1,PHI35/tree/MATH500/3_1000.jsonl,78
PHI3.5,tree,3,3_1000#79,95,502,597,0,PHI35/tree/MATH500/3_1000.jsonl,79
PHI3.5,tree,3,3_1000#80,43,75,118,1,PHI35/tree/MATH500/3_1000.jsonl,80
PHI3.5,tree,3,3_1000#81,70,295,365,0,PHI35/tree/MATH500/3_1000.jsonl,81
PHI3.5,tree,3,3_1000#82,72,266,338,1,PHI35/tree/MATH500/3_1000.jsonl,82
PHI3.5,tree,3,3_1000#83,106,197,303,0,PHI35/tree/MATH500/3_1000.jsonl,83
PHI3.5,tree,3,3_1000#84,45,304,349,0,PHI35/tree/MATH500/3_1000.jsonl,84
PHI3.5,tree,3,3_1000#85,79,342,421,0,PHI35/tree/MATH500/3_1000.jsonl,85
PHI3.5,tree,3,3_1000#86,87,255,342,1,PHI35/tree/MATH500/3_1000.jsonl,86
PHI3.5,tree,3,3_1000#87,68,158,226,1,PHI35/tree/MATH500/3_1000.jsonl,87
PHI3.5,tree,3,3_1000#88,45,108,153,1,PHI35/tree/MATH500/3_1000.jsonl,88
PHI3.5,tree,3,3_1000#89,116,229,345,0,PHI35/tree/MATH500/3_1000.jsonl,89
PHI3.5,tree,3,3_1000#90,48,511,559,0,PHI35/tree/MATH500/3_1000.jsonl,90
PHI3.5,tree,3,3_1000#91,64,110,174,1,PHI35/tree/MATH500/3_1000.jsonl,91
PHI3.5,tree,3,3_1000#92,66,107,173,0,PHI35/tree/MATH500/3_1000.jsonl,92
PHI3.5,tree,3,3_1000#93,66,493,559,0,PHI35/tree/MATH500/3_1000.jsonl,93
PHI3.5,tree,3,3_1000#94,65,203,268,1,PHI35/tree/MATH500/3_1000.jsonl,94
PHI3.5,tree,3,3_1000#95,434,259,693,0,PHI35/tree/MATH500/3_1000.jsonl,95
PHI3.5,tree,3,3_1000#96,94,843,937,0,PHI35/tree/MATH500/3_1000.jsonl,96
PHI3.5,tree,3,3_1000#97,131,759,890,0,PHI35/tree/MATH500/3_1000.jsonl,97
PHI3.5,tree,3,3_1000#98,70,276,346,0,PHI35/tree/MATH500/3_1000.jsonl,98
PHI3.5,tree,3,3_1000#99,40,108,148,0,PHI35/tree/MATH500/3_1000.jsonl,99
PHI3.5,tree,3,3_1000#100,108,484,592,0,PHI35/tree/MATH500/3_1000.jsonl,100
PHI3.5,tree,9,9_1000#1,71,231,302,0,PHI35/tree/MATH500/9_1000.jsonl,1
PHI3.5,tree,9,9_1000#2,123,891,1014,0,PHI35/tree/MATH500/9_1000.jsonl,2
PHI3.5,tree,9,9_1000#3,69,276,345,1,PHI35/tree/MATH500/9_1000.jsonl,3
PHI3.5,tree,9,9_1000#4,37,122,159,1,PHI35/tree/MATH500/9_1000.jsonl,4
PHI3.5,tree,9,9_1000#5,402,327,729,0,PHI35/tree/MATH500/9_1000.jsonl,5
PHI3.5,tree,9,9_1000#6,69,109,178,1,PHI35/tree/MATH500/9_1000.jsonl,6
PHI3.5,tree,9,9_1000#7,41,180,221,1,PHI35/tree/MATH500/9_1000.jsonl,7
PHI3.5,tree,9,9_1000#8,96,661,757,0,PHI35/tree/MATH500/9_1000.jsonl,8
PHI3.5,tree,9,9_1000#9,56,295,351,1,PHI35/tree/MATH500/9_1000.jsonl,9
PHI3.5,tree,9,9_1000#10,172,267,439,0,PHI35/tree/MATH500/9_1000.jsonl,10
PHI3.5,tree,9,9_1000#11,47,192,239,0,PHI35/tree/MATH500/9_1000.jsonl,11
PHI3.5,tree,9,9_1000#12,85,1001,1086,0,PHI35/tree/MATH500/9_1000.jsonl,12
PHI3.5,tree,9,9_1000#13,95,225,320,1,PHI35/tree/MATH500/9_1000.jsonl,13
PHI3.5,tree,9,9_1000#14,221,142,363,1,PHI35/tree/MATH500/9_1000.jsonl,14
PHI3.5,tree,9,9_1000#15,163,92,255,0,PHI35/tree/MATH500/9_1000.jsonl,15
PHI3.5,tree,9,9_1000#16,233,807,1040,0,PHI35/tree/MATH500/9_1000.jsonl,16
PHI3.5,tree,9,9_1000#17,46,114,160,1,PHI35/tree/MATH500/9_1000.jsonl,17
PHI3.5,tree,9,9_1000#18,280,189,469,0,PHI35/tree/MATH500/9_1000.jsonl,18
PHI3.5,tree,9,9_1000#19,187,113,300,0,PHI35/tree/MATH500/9_1000.jsonl,19
PHI3.5,tree,9,9_1000#20,69,180,249,0,PHI35/tree/MATH500/9_1000.jsonl,20
PHI3.5,tree,9,9_1000#21,36,103,139,1,PHI35/tree/MATH500/9_1000.jsonl,21
PHI3.5,tree,9,9_1000#22,50,466,516,0,PHI35/tree/MATH500/9_1000.jsonl,22
PHI3.5,tree,9,9_1000#23,159,283,442,0,PHI35/tree/MATH500/9_1000.jsonl,23
PHI3.5,tree,9,9_1000#24,50,412,462,0,PHI35/tree/MATH500/9_1000.jsonl,24
PHI3.5,tree,9,9_1000#25,132,371,503,0,PHI35/tree/MATH500/9_1000.jsonl,25
PHI3.5,tree,9,9_1000#26,107,1001,1108,0,PHI35/tree/MATH500/9_1000.jsonl,26
PHI3.5,tree,9,9_1000#27,76,330,406,0,PHI35/tree/MATH500/9_1000.jsonl,27
PHI3.5,tree,9,9_1000#28,110,219,329,0,PHI35/tree/MATH500/9_1000.jsonl,28
PHI3.5,tree,9,9_1000#29,58,99,157,1,PHI35/tree/MATH500/9_1000.jsonl,29
PHI3.5,tree,9,9_1000#30,103,546,649,1,PHI35/tree/MATH500/9_1000.jsonl,30
PHI3.5,tree,9,9_1000#31,45,202,247,1,PHI35/tree/MATH500/9_1000.jsonl,31
PHI3.5,tree,9,9_1000#32,32,144,176,0,PHI35/tree/MATH500/9_1000.jsonl,32
PHI3.5,tree,9,9_1000#33,73,133,206,1,PHI35/tree/MATH500/9_1000.jsonl,33
PHI3.5,tree,9,9_1000#34,70,268,338,0,PHI35/tree/MATH500/9_1000.jsonl,34
PHI3.5,tree,9,9_1000#35,52,499,551,0,PHI35/tree/MATH500/9_1000.jsonl,35
PHI3.5,tree,9,9_1000#36,61,306,367,0,PHI35/tree/MATH500/9_1000.jsonl,36
PHI3.5,tree,9,9_1000#37,51,483,534,0,PHI35/tree/MATH500/9_1000.jsonl,37
PHI3.5,tree,9,9_1000#38,57,146,203,1,PHI35/tree/MATH500/9_1000.jsonl,38
PHI3.5,tree,9,9_1000#39,72,100,172,1,PHI35/tree/MATH500/9_1000.jsonl,39
PHI3.5,tree,9,9_1000#40,49,311,360,0,PHI35/tree/MATH500/9_1000.jsonl,40
PHI3.5,tree,9,9_1000#41,137,68,205,1,PHI35/tree/MATH500/9_1000.jsonl,41
PHI3.5,tree,9,9_1000#42,72,580,652,0,PHI35/tree/MATH500/9_1000.jsonl,42
PHI3.5,tree,9,9_1000#43,61,132,193,0,PHI35/tree/MATH500/9_1000.jsonl,43
PHI3.5,tree,9,9_1000#44,108,396,504,0,PHI35/tree/MATH500/9_1000.jsonl,44
PHI3.5,tree,9,9_1000#45,87,248,335,1,PHI35/tree/MATH500/9_1000.jsonl,45
PHI3.5,tree,9,9_1000#46,58,276,334,1,PHI35/tree/MATH500/9_1000.jsonl,46
PHI3.5,tree,9,9_1000#47,64,786,850,0,PHI35/tree/MATH500/9_1000.jsonl,47
PHI3.5,tree,9,9_1000#48,78,221,299,1,PHI35/tree/MATH500/9_1000.jsonl,48
PHI3.5,tree,9,9_1000#49,41,175,216,1,PHI35/tree/MATH500/9_1000.jsonl,49
PHI3.5,tree,9,9_1000#50,47,97,144,1,PHI35/tree/MATH500/9_1000.jsonl,50
PHI3.5,tree,9,9_1000#51,137,487,624,0,PHI35/tree/MATH500/9_1000.jsonl,51
PHI3.5,tree,9,9_1000#52,44,459,503,0,PHI35/tree/MATH500/9_1000.jsonl,52
PHI3.5,tree,9,9_1000#53,51,199,250,1,PHI35/tree/MATH500/9_1000.jsonl,53
PHI3.5,tree,9,9_1000#54,50,99,149,1,PHI35/tree/MATH500/9_1000.jsonl,54
PHI3.5,tree,9,9_1000#55,35,79,114,1,PHI35/tree/MATH500/9_1000.jsonl,55
PHI3.5,tree,9,9_1000#56,75,133,208,1,PHI35/tree/MATH500/9_1000.jsonl,56
PHI3.5,tree,9,9_1000#57,47,67,114,1,PHI35/tree/MATH500/9_1000.jsonl,57
PHI3.5,tree,9,9_1000#58,79,181,260,1,PHI35/tree/MATH500/9_1000.jsonl,58
PHI3.5,tree,9,9_1000#59,39,167,206,1,PHI35/tree/MATH500/9_1000.jsonl,59
PHI3.5,tree,9,9_1000#60,77,197,274,1,PHI35/tree/MATH500/9_1000.jsonl,60
PHI3.5,tree,9,9_1000#61,76,606,682,0,PHI35/tree/MATH500/9_1000.jsonl,61
PHI3.5,tree,9,9_1000#62,91,265,356,1,PHI35/tree/MATH500/9_1000.jsonl,62
PHI3.5,tree,9,9_1000#63,123,512,635,0,PHI35/tree/MATH500/9_1000.jsonl,63
PHI3.5,tree,9,9_1000#64,119,245,364,0,PHI35/tree/MATH500/9_1000.jsonl,64
PHI3.5,tree,9,9_1000#65,86,605,691,0,PHI35/tree/MATH500/9_1000.jsonl,65
PHI3.5,tree,9,9_1000#66,41,67,108,1,PHI35/tree/MATH500/9_1000.jsonl,66
PHI3.5,tree,9,9_1000#67,65,225,290,0,PHI35/tree/MATH500/9_1000.jsonl,67
PHI3.5,tree,9,9_1000#68,72,208,280,0,PHI35/tree/MATH500/9_1000.jsonl,68
PHI3.5,tree,9,9_1000#69,88,547,635,0,PHI35/tree/MATH500/9_1000.jsonl,69
PHI3.5,tree,9,9_1000#70,78,816,894,0,PHI35/tree/MATH500/9_1000.jsonl,70
PHI3.5,tree,9,9_1000#71,44,126,170,1,PHI35/tree/MATH500/9_1000.jsonl,71
PHI3.5,tree,9,9_1000#72,49,223,272,0,PHI35/tree/MATH500/9_1000.jsonl,72
PHI3.5,tree,9,9_1000#73,57,276,333,1,PHI35/tree/MATH500/9_1000.jsonl,73
PHI3.5,tree,9,9_1000#74,89,176,265,1,PHI35/tree/MATH500/9_1000.jsonl,74
PHI3.5,tree,9,9_1000#75,47,188,235,1,PHI35/tree/MATH500/9_1000.jsonl,75
PHI3.5,tree,9,9_1000#76,62,182,244,0,PHI35/tree/MATH500/9_1000.jsonl,76
PHI3.5,tree,9,9_1000#77,61,85,146,1,PHI35/tree/MATH500/9_1000.jsonl,77
PHI3.5,tree,9,9_1000#78,40,101,141,1,PHI35/tree/MATH500/9_1000.jsonl,78
PHI3.5,tree,9,9_1000#79,95,539,634,0,PHI35/tree/MATH500/9_1000.jsonl,79
PHI3.5,tree,9,9_1000#80,43,94,137,1,PHI35/tree/MATH500/9_1000.jsonl,80
PHI3.5,tree,9,9_1000#81,70,262,332,0,PHI35/tree/MATH500/9_1000.jsonl,81
PHI3.5,tree,9,9_1000#82,72,266,338,1,PHI35/tree/MATH500/9_1000.jsonl,82
PHI3.5,tree,9,9_1000#83,106,201,307,0,PHI35/tree/MATH500/9_1000.jsonl,83
PHI3.5,tree,9,9_1000#84,45,568,613,0,PHI35/tree/MATH500/9_1000.jsonl,84
PHI3.5,tree,9,9_1000#85,79,480,559,0,PHI35/tree/MATH500/9_1000.jsonl,85
PHI3.5,tree,9,9_1000#86,87,255,342,1,PHI35/tree/MATH500/9_1000.jsonl,86
PHI3.5,tree,9,9_1000#87,68,157,225,1,PHI35/tree/MATH500/9_1000.jsonl,87
PHI3.5,tree,9,9_1000#88,45,108,153,1,PHI35/tree/MATH500/9_1000.jsonl,88
PHI3.5,tree,9,9_1000#89,116,243,359,0,PHI35/tree/MATH500/9_1000.jsonl,89
PHI3.5,tree,9,9_1000#90,48,361,409,0,PHI35/tree/MATH500/9_1000.jsonl,90
PHI3.5,tree,9,9_1000#91,64,112,176,0,PHI35/tree/MATH500/9_1000.jsonl,91
PHI3.5,tree,9,9_1000#92,66,107,173,0,PHI35/tree/MATH500/9_1000.jsonl,92
PHI3.5,tree,9,9_1000#93,66,600,666,0,PHI35/tree/MATH500/9_1000.jsonl,93
PHI3.5,tree,9,9_1000#94,65,220,285,1,PHI35/tree/MATH500/9_1000.jsonl,94
PHI3.5,tree,9,9_1000#95,434,466,900,0,PHI35/tree/MATH500/9_1000.jsonl,95
PHI3.5,tree,9,9_1000#96,94,522,616,0,PHI35/tree/MATH500/9_1000.jsonl,96
PHI3.5,tree,9,9_1000#97,131,838,969,0,PHI35/tree/MATH500/9_1000.jsonl,97
PHI3.5,tree,9,9_1000#98,70,264,334,0,PHI35/tree/MATH500/9_1000.jsonl,98
PHI3.5,tree,9,9_1000#99,40,107,147,0,PHI35/tree/MATH500/9_1000.jsonl,99
PHI3.5,tree,9,9_1000#100,108,568,676,0,PHI35/tree/MATH500/9_1000.jsonl,100
PHI3.5,sampling,,sample#1,71,227,298,0,PHI35/sample/MATH500/sample.jsonl,1
PHI3.5,sampling,,sample#2,123,609,732,0,PHI35/sample/MATH500/sample.jsonl,2
PHI3.5,sampling,,sample#3,69,264,333,1,PHI35/sample/MATH500/sample.jsonl,3
PHI3.5,sampling,,sample#4,37,132,169,1,PHI35/sample/MATH500/sample.jsonl,4
PHI3.5,sampling,,sample#5,402,299,701,0,PHI35/sample/MATH500/sample.jsonl,5
PHI3.5,sampling,,sample#6,69,162,231,1,PHI35/sample/MATH500/sample.jsonl,6
PHI3.5,sampling,,sample#7,41,163,204,0,PHI35/sample/MATH500/sample.jsonl,7
PHI3.5,sampling,,sample#8,96,271,367,0,PHI35/sample/MATH500/sample.jsonl,8
PHI3.5,sampling,,sample#9,56,192,248,0,PHI35/sample/MATH500/sample.jsonl,9
PHI3.5,sampling,,sample#10,172,380,552,1,PHI35/sample/MATH500/sample.jsonl,10
PHI3.5,sampling,,sample#11,47,210,257,0,PHI35/sample/MATH500/sample.jsonl,11
PHI3.5,sampling,,sample#12,85,229,314,0,PHI35/sample/MATH500/sample.jsonl,12
PHI3.5,sampling,,sample#13,95,238,333,0,PHI35/sample/MATH500/sample.jsonl,13
PHI3.5,sampling,,sample#14,221,141,362,1,PHI35/sample/MATH500/sample.jsonl,14
PHI3.5,sampling,,sample#15,163,81,244,0,PHI35/sample/MATH500/sample.jsonl,15
PHI3.5,sampling,,sample#16,233,401,634,0,PHI35/sample/MATH500/sample.jsonl,16
PHI3.5,sampling,,sample#17,46,146,192,0,PHI35/sample/MATH500/sample.jsonl,17
PHI3.5,sampling,,sample#18,280,255,535,0,PHI35/sample/MATH500/sample.jsonl,18
PHI3.5,sampling,,sample#19,187,231,418,0,PHI35/sample/MATH500/sample.jsonl,19
PHI3.5,sampling,,sample#20,69,379,448,0,PHI35/sample/MATH500/sample.jsonl,20
PHI3.5,sampling,,sample#21,36,101,137,1,PHI35/sample/MATH500/sample.jsonl,21
PHI3.5,sampling,,sample#22,50,408,458,0,PHI35/sample/MATH500/sample.jsonl,22
PHI3.5,sampling,,sample#23,159,427,586,0,PHI35/sample/MATH500/sample.jsonl,23
PHI3.5,sampling,,sample#24,50,545,595,0,PHI35/sample/MATH500/sample.jsonl,24
PHI3.5,sampling,,sample#25,132,419,551,0,PHI35/sample/MATH500/sample.jsonl,25
PHI3.5,sampling,,sample#26,107,123,230,0,PHI35/sample/MATH500/sample.jsonl,26
PHI3.5,sampling,,sample#27,76,225,301,1,PHI35/sample/MATH500/sample.jsonl,27
PHI3.5,sampling,,sample#28,110,191,301,0,PHI35/sample/MATH500/sample.jsonl,28
PHI3.5,sampling,,sample#29,58,80,138,1,PHI35/sample/MATH500/sample.jsonl,29
PHI3.5,sampling,,sample#30,103,498,601,1,PHI35/sample/MATH500/sample.jsonl,30
PHI3.5,sampling,,sample#31,45,128,173,1,PHI35/sample/MATH500/sample.jsonl,31
PHI3.5,sampling,,sample#32,32,148,180,0,PHI35/sample/MATH500/sample.jsonl,32
PHI3.5,sampling,,sample#33,73,127,200,1,PHI35/sample/MATH500/sample.jsonl,33
PHI3.5,sampling,,sample#34,70,249,319,0,PHI35/sample/MATH500/sample.jsonl,34
PHI3.5,sampling,,sample#35,52,283,335,0,PHI35/sample/MATH500/sample.jsonl,35
PHI3.5,sampling,,sample#36,61,211,272,1,PHI35/sample/MATH500/sample.jsonl,36
PHI3.5,sampling,,sample#37,51,428,479,0,PHI35/sample/MATH500/sample.jsonl,37
PHI3.5,sampling,,sample#38,57,164,221,0,PHI35/sample/MATH500/sample.jsonl,38
PHI3.5,sampling,,sample#39,72,92,164,1,PHI35/sample/MATH500/sample.jsonl,39
PHI3.5,sampling,,sample#40,49,230,279,0,PHI35/sample/MATH500/sample.jsonl,40
PHI3.5,sampling,,sample#41,137,66,203,1,PHI35/sample/MATH500/sample.jsonl,41
PHI3.5,sampling,,sample#42,72,316,388,1,PHI35/sample/MATH500/sample.jsonl,42
PHI3.5,sampling,,sample#43,61,119,180,1,PHI35/sample/MATH500/sample.jsonl,43
PHI3.5,sampling,,sample#44,108,371,479,0,PHI35/sample/MATH500/sample.jsonl,44
PHI3.5,sampling,,sample#45,87,287,374,0,PHI35/sample/MATH500/sample.jsonl,45
PHI3.5,sampling,,sample#46,58,253,311,1,PHI35/sample/MATH500/sample.jsonl,46
PHI3.5,sampling,,sample#47,64,726,790,0,PHI35/sample/MATH500/sample.jsonl,47
PHI3.5,sampling,,sample#48,78,193,271,1,PHI35/sample/MATH500/sample.jsonl,48
PHI3.5,sampling,,sample#49,41,84,125,0,PHI35/sample/MATH500/sample.jsonl,49
PHI3.5,sampling,,sample#50,47,290,337,1,PHI35/sample/MATH500/sample.jsonl,50
PHI3.5,sampling,,sample#51,137,1000,1137,0,PHI35/sample/MATH500/sample.jsonl,51
PHI3.5,sampling,,sample#52,44,339,383,1,PHI35/sample/MATH500/sample.jsonl,52
PHI3.5,sampling,,sample#53,51,223,274,1,PHI35/sample/MATH500/sample.jsonl,53
PHI3.5,sampling,,sample#54,50,145,195,0,PHI35/sample/MATH500/sample.jsonl,54
PHI3.5,sampling,,sample#55,35,87,122,1,PHI35/sample/MATH500/sample.jsonl,55
PHI3.5,sampling,,sample#56,75,165,240,1,PHI35/sample/MATH500/sample.jsonl,56
PHI3.5,sampling,,sample#57,47,69,116,1,PHI35/sample/MATH500/sample.jsonl,57
PHI3.5,sampling,,sample#58,79,317,396,1,PHI35/sample/MATH500/sample.jsonl,58
PHI3.5,sampling,,sample#59,39,143,182,1,PHI35/sample/MATH500/sample.jsonl,59
PHI3.5,sampling,,sample#60,77,338,415,1,PHI35/sample/MATH500/sample.jsonl,60
PHI3.5,sampling,,sample#61,76,313,389,0,PHI35/sample/MATH500/sample.jsonl,61
PHI3.5,sampling,,sample#62,91,293,384,0,PHI35/sample/MATH500/sample.jsonl,62
PHI3.5,sampling,,sample#63,123,467,590,0,PHI35/sample/MATH500/sample.jsonl,63
PHI3.5,sampling,,sample#64,119,331,450,0,PHI35/sample/MATH500/sample.jsonl,64
PHI3.5,sampling,,sample#65,86,466,552,0,PHI35/sample/MATH500/sample.jsonl,65
PHI3.5,sampling,,sample#66,41,79,120,1,PHI35/sample/MATH500/sample.jsonl,66
PHI3.5,sampling,,sample#67,65,309,374,0,PHI35/sample/MATH500/sample.jsonl,67
PHI3.5,sampling,,sample#68,72,162,234,0,PHI35/sample/MATH500/sample.jsonl,68
PHI3.5,sampling,,sample#69,88,342,430,0,PHI35/sample/MATH500/sample.jsonl,69
PHI3.5,sampling,,sample#70,78,567,645,0,PHI35/sample/MATH500/sample.jsonl,70
PHI3.5,sampling,,sample#71,44,240,284,1,PHI35/sample/MATH500/sample.jsonl,71
PHI3.5,sampling,,sample#72,49,187,236,0,PHI35/sample/MATH500/sample.jsonl,72
PHI3.5,sampling,,sample#73,57,220,277,1,PHI35/sample/MATH500/sample.jsonl,73
PHI3.5,sampling,,sample#74,89,186,275,1,PHI35/sample/MATH500/sample.jsonl,74
PHI3.5,sampling,,sample#75,47,218,265,1,PHI35/sample/MATH500/sample.jsonl,75
PHI3.5,sampling,,sample#76,62,249,311,0,PHI35/sample/MATH500/sample.jsonl,76
PHI3.5,sampling,,sample#77,61,197,258,1,PHI35/sample/MATH500/sample.jsonl,77
PHI3.5,sampling,,sample#78,40,113,153,1,PHI35/sample/MATH500/sample.jsonl,78
PHI3.5,sampling,,sample#79,95,530,625,0,PHI35/sample/MATH500/sample.jsonl,79
PHI3.5,sampling,,sample#80,43,85,128,1,PHI35/sample/MATH500/sample.jsonl,80
PHI3.5,sampling,,sample#81,70,414,484,0,PHI35/sample/MATH500/sample.jsonl,81
PHI3.5,sampling,,sample#82,72,326,398,1,PHI35/sample/MATH500/sample.jsonl,82
PHI3.5,sampling,,sample#83,106,186,292,0,PHI35/sample/MATH500/sample.jsonl,83
PHI3.5,sampling,,sample#84,45,510,555,0,PHI35/sample/MATH500/sample.jsonl,84
PHI3.5,sampling,,sample#85,79,446,525,0,PHI35/sample/MATH500/sample.jsonl,85
PHI3.5,sampling,,sample#86,87,241,328,1,PHI35/sample/MATH500/sample.jsonl,86
PHI3.5,sampling,,sample#87,68,200,268,1,PHI35/sample/MATH500/sample.jsonl,87
PHI3.5,sampling,,sample#88,45,100,145,1,PHI35/sample/MATH500/sample.jsonl,88
PHI3.5,sampling,,sample#89,116,197,313,1,PHI35/sample/MATH500/sample.jsonl,89
PHI3.5,sampling,,sample#90,48,298,346,0,PHI35/sample/MATH500/sample.jsonl,90
PHI3.5,sampling,,sample#91,64,93,157,0,PHI35/sample/MATH500/sample.jsonl,91
PHI3.5,sampling,,sample#92,66,149,215,0,PHI35/sample/MATH500/sample.jsonl,92
PHI3.5,sampling,,sample#93,66,261,327,0,PHI35/sample/MATH500/sample.jsonl,93
PHI3.5,sampling,,sample#94,65,189,254,0,PHI35/sample/MATH500/sample.jsonl,94
PHI3.5,sampling,,sample#95,434,228,662,0,PHI35/sample/MATH500/sample.jsonl,95
PHI3.5,sampling,,sample#96,94,543,637,1,PHI35/sample/MATH500/sample.jsonl,96
PHI3.5,sampling,,sample#97,131,827,958,0,PHI35/sample/MATH500/sample.jsonl,97
PHI3.5,sampling,,sample#98,70,387,457,0,PHI35/sample/MATH500/sample.jsonl,98
PHI3.5,sampling,,sample#99,40,74,114,0,PHI35/sample/MATH500/sample.jsonl,99
PHI3.5,sampling,,sample#100,108,319,427,0,PHI35/sample/MATH500/sample.jsonl,100
